Unnamed: 0,Film,Budget,Revenue,Novel,Earnings,First Letter
0,(500) Days of Summer,7500000,60722734,0.0,53222734,(
1,10 Cloverfield Lane,15000000,108286421,0.0,93286421,1
2,12 Rounds,20000000,17280326,0.0,-2719674,1
3,12 Years a Slave,20000000,187000000,1.0,167000000,1
4,127 Hours,18000000,35692920,0.0,17692920,1
5,13 Going on 30,37000000,96455697,0.0,59455697,1
6,13 Hours: The Secret Soldiers of Benghazi,50000000,69411370,0.0,19411370,1
7,1408,25000000,94679598,0.0,69679598,1
8,16 Blocks,55000000,65664721,0.0,10664721,1
9,17 Again,20000000,136267476,0.0,116267476,1
10,2 Fast 2 Furious,76000000,236350661,0.0,160350661,2
11,2 Guns,61000000,131940411,0.0,70940411,2
12,2012,200000000,769653595,0.0,569653595,2
13,20th Century Women,7000000,5816211,0.0,-1183789,2
14,21,35000000,69823199,0.0,34823199,2
15,21 Jump Street,42000000,201585328,0.0,159585328,2
16,22 Jump Street,50000000,188441614,0.0,138441614,2
17,27 Dresses,30000000,160259319,0.0,130259319,2
18,28 Days Later,5000000,82719885,0.0,77719885,2
19,28 Weeks Later,15000000,64238440,0.0,49238440,2
20,3 Days to Kill,28000000,52597999,0.0,24597999,3
21,30 Days of Night,30000000,75505973,0.0,45505973,3
22,30 Minutes or Less,28000000,40547440,0.0,12547440,3
23,300,65000000,422610419,0.0,357610419,3
24,42,40000000,95020213,0.0,55020213,4
25,47 Meters Down,5500000,44235023,0.0,38735023,4
26,47 Ronin,175000000,150962475,0.0,-24037525,4
27,50 First Dates,75000000,196482882,0.0,121482882,5
28,50/50,8000000,39187783,0.0,31187783,5
29,8 Mile,41000000,215000000,0.0,174000000,8
30,88 Minutes,30000000,16930884,0.0,-13069116,8
31,9,30000000,48428063,0.0,18428063,9
32,90 Minutes in Heaven,5000000,4842699,1.0,-157301,9
33,99 Homes,8000000,1411927,0.0,-6588073,9
34,A Cinderella Story,19000000,70067909,0.0,51067909,A
35,A Cure for Wellness,40000000,26559557,0.0,-13440443,A
36,A Dog's Purpose,22000000,194647323,1.0,172647323,A
37,A Good Day to Die Hard,92000000,304654182,0.0,212654182,A
38,A Good Year,35000000,42064105,1.0,7064105,A
39,A Guy Thing,20000000,17432163,0.0,-2567837,A
40,A Haunted House,2500000,60141683,0.0,57641683,A
41,A History of Violence,32000000,60740827,0.0,28740827,A
42,A Lot Like Love,30000000,42886719,0.0,12886719,A
43,A Man Apart,36000000,44350926,0.0,8350926,A
44,A Mighty Heart,16000000,18928871,0.0,2928871,A
45,A Mighty Wind,6000000,18750246,0.0,12750246,A
46,A Monster Calls,43000000,46652768,0.0,3652768,A
47,A Most Violent Year,20000000,12007070,0.0,-7992930,A
48,A Most Wanted Man,15000000,31554855,1.0,16554855,A
49,A Perfect Getaway,14000000,22852638,0.0,8852638,A
50,A Sound of Thunder,80000000,5989640,0.0,-74010360,A
51,A Thousand Words,40000000,22044277,0.0,-17955723,A
52,A Walk Among the Tombstones,28000000,53181600,1.0,25181600,A
53,A Walk in the Woods,8000000,35991087,0.0,27991087,A
54,A Walk to Remember,11000000,41227069,1.0,30227069,A
55,ATL,20000000,21170563,0.0,1170563,A
56,Abandon,25000000,10719357,0.0,-14280643,A
57,Abduction,35000000,82087155,0.0,47087155,A
58,About Schmidt,30000000,105834556,1.0,75834556,A
59,About Time,12000000,87100449,0.0,75100449,A
60,About a Boy,27000000,129000000,1.0,102000000,A
61,Abraham Lincoln: Vampire Hunter,69000000,112265139,1.0,43265139,A
62,Accepted,23000000,38505009,0.0,15505009,A
63,Act of Valor,12000000,81272766,0.0,69272766,A
64,Adaptation.,19000000,32801173,1.0,13801173,A
65,Admission,13000000,18000000,1.0,5000000,A
66,Adventureland,9500000,17164377,0.0,7664377,A
67,After Earth,130000000,243843127,0.0,113843127,A
68,After the Sunset,60000000,61347797,0.0,1347797,A
69,Against the Ropes,39000000,6614280,0.0,-32385720,A
70,Agent Cody Banks,28000000,58795814,0.0,30795814,A
71,Agent Cody Banks 2: Destination London,26000000,28818995,0.0,2818995,A
72,Akeelah and the Bee,8000000,18948425,0.0,10948425,A
73,Alex Cross,45000000,30353232,1.0,-14646768,A
74,Alexander,155000000,167298192,0.0,12298192,A
75,"Alexander and the Terrible, Horrible, No Good, Very Bad Day",28000000,100654149,0.0,72654149,A
76,Alfie,60000000,13395939,0.0,-46604061,A
77,Alice Through the Looking Glass,170000000,299370084,1.0,129370084,A
78,Alien: Covenant,97000000,232380243,0.0,135380243,A
79,Aliens in the Attic,45000000,57881056,0.0,12881056,A
80,All About Steve,15000000,40105542,0.0,25105542,A
81,All About the Benjamins,14000000,25482931,0.0,11482931,A
82,All the King's Men,55000000,9450897,1.0,-45549103,A
83,Allied,85000000,119520023,0.0,34520023,A
84,Almost Christmas,17000000,42487325,0.0,25487325,A
85,Aloha,37000000,26250020,0.0,-10749980,A
86,Alone in the Dark,20000000,10442808,0.0,-9557192,A
87,Along Came Polly,42000000,171963386,0.0,129963386,A
88,Alpha and Omega,20000000,39300000,0.0,19300000,A
89,Alvin and the Chipmunks,60000000,361366633,0.0,301366633,A
90,Alvin and the Chipmunks: Chipwrecked,75000000,342695435,0.0,267695435,A
91,Alvin and the Chipmunks: The Squeakquel,75000000,443140005,0.0,368140005,A
92,Amelia,40000000,19258519,0.0,-20741481,A
93,American Dreamz,17000000,7314027,0.0,-9685973,A
94,American Gangster,100000000,266465037,0.0,166465037,A
95,American Hustle,40000000,251171807,0.0,211171807,A
96,American Reunion,50000000,234989584,0.0,184989584,A
97,American Sniper,58800000,542307423,0.0,483507423,A
98,American Ultra,28000000,27139524,0.0,-860476,A
99,American Wedding,55000000,231449203,0.0,176449203,A
100,An American Carol,20000000,7000000,0.0,-13000000,A
101,An Education,7500000,26096852,0.0,18596852,A
102,An Unfinished Life,30000000,18618284,0.0,-11381716,A
103,Anacondas: The Hunt for the Blood Orchid,20000000,70992898,0.0,50992898,A
104,Analyze That,60000000,55003135,0.0,-4996865,A
105,Anchorman 2: The Legend Continues,50000000,173649015,0.0,123649015,A
106,Anchorman: The Legend of Ron Burgundy,26000000,90574188,0.0,64574188,A
107,And So It Goes,18000000,25312387,0.0,7312387,A
108,Angels & Demons,150000000,356613439,1.0,206613439,A
109,Anger Management,75000000,195745823,0.0,120745823,A
110,Annabelle,6500000,255273813,0.0,248773813,A
111,Annapolis,26000000,17496992,0.0,-8503008,A
112,Ant-Man,130000000,519311965,0.0,389311965,A
113,Antwone Fisher,12500000,23367586,0.0,10867586,A
114,Apocalypto,40000000,120175290,0.0,80175290,A
115,Apollo 18,5000000,25562924,0.0,20562924,A
116,Appaloosa,20000000,20211394,1.0,211394,A
117,Aquamarine,12000000,23006849,1.0,11006849,A
118,Are We There Yet?,32000000,97918663,0.0,65918663,A
119,Argo,44500000,232324128,0.0,187824128,A
120,Armored,20000000,22942221,0.0,2942221,A
121,Around the World in 80 Days,110000000,72178895,1.0,-37821105,A
122,Arrival,47000000,203388186,0.0,156388186,A
123,Assassin's Creed,125000000,240697856,0.0,115697856,A
124,Assault on Precinct 13,30000000,35294470,0.0,5294470,A
125,Astro Boy,65000000,44091067,0.0,-20908933,A
126,Atomic Blonde,30000000,90007945,1.0,60007945,A
127,Atonement,30000000,129266061,0.0,99266061,A
128,August Rush,25000000,66122026,0.0,41122026,A
129,August: Osage County,25000000,74188937,0.0,49188937,A
130,Austin Powers in Goldmember,63000000,296655431,0.0,233655431,A
131,Australia,130000000,49554002,0.0,-80445998,A
132,Avatar,237000000,2787965087,1.0,2550965087,A
133,Avengers: Age of Ultron,280000000,1405403694,0.0,1125403694,A
134,Awake,86000000,14373825,0.0,-71626175,A
135,Babel,25000000,135330182,0.0,110330182,B
136,Baby Driver,34000000,224511319,0.0,190511319,B
137,Baby Mama,30000000,63833449,0.0,33833449,B
138,Babylon A.D.,70000000,72108608,1.0,2108608,B
139,Bad Boys II,130000000,273339556,0.0,143339556,B
140,Bad Company,70000000,65977295,0.0,-4022705,B
141,Bad Moms,20000000,183936074,0.0,163936074,B
142,Bad News Bears,30000000,34252847,0.0,4252847,B
143,Bad Santa,23000000,76488889,0.0,53488889,B
144,Bad Santa 2,26000000,17782178,0.0,-8217822,B
145,Bad Teacher,20000000,216197492,0.0,196197492,B
146,Bad Words,9500000,7800000,0.0,-1700000,B
147,Baggage Claim,8500000,22456509,0.0,13956509,B
148,Ballistic: Ecks vs. Sever,70000000,19924033,0.0,-50075967,B
149,Bandslam,20000000,5210988,0.0,-14789012,B
150,Bangkok Dangerous,45000000,42487390,0.0,-2512610,B
151,Barbershop,12000000,75781642,0.0,63781642,B
152,Barbershop: The Next Cut,20000000,55030051,0.0,35030051,B
153,Basic,50000000,42792561,0.0,-7207439,B
154,Basic Instinct 2,70000000,38629478,0.0,-31370522,B
155,Batman Begins,150000000,374218673,0.0,224218673,B
156,Batman v Superman: Dawn of Justice,250000000,873260194,0.0,623260194,B
157,Battle for Terra,4000000,6101046,0.0,2101046,B
158,Battle of the Year,20000000,16549477,0.0,-3450523,B
159,Battle: Los Angeles,70000000,202466756,0.0,132466756,B
160,Battleship,209000000,303025485,0.0,94025485,B
161,Baywatch,69000000,177856751,0.0,108856751,B
162,Be Cool,53000000,95226116,1.0,42226116,B
163,Beastly,17000000,43165571,1.0,26165571,B
164,Beauty Shop,25000000,36351350,0.0,11351350,B
165,Because of Winn-Dixie,14000000,32645546,1.0,18645546,B
166,Becoming Jane,16500000,37311672,0.0,20811672,B
167,Bedtime Stories,80000000,212874442,0.0,132874442,B
168,Bee Movie,150000000,287594577,0.0,137594577,B
169,Beerfest,17500000,19179969,0.0,1679969,B
170,Before I Fall,5000000,10025571,1.0,5025571,B
171,Before Midnight,3000000,11176469,0.0,8176469,B
172,Begin Again,8000000,63464861,0.0,55464861,B
173,Bend It Like Beckham,3500159,76578641,0.0,73078482,B
174,Beowulf,70000000,195735876,0.0,125735876,B
175,Beverly Hills Chihuahua,20000000,149281606,0.0,129281606,B
176,Bewitched,85000000,131426169,0.0,46426169,B
177,Beyond the Lights,7000000,14618727,0.0,7618727,B
178,Big Eyes,10000000,28883511,0.0,18883511,B
179,Big Fat Liar,15000000,52970014,0.0,37970014,B
180,Big Fish,70000000,122919055,1.0,52919055,B
181,Big Hero 6,165000000,652105443,0.0,487105443,B
182,Big Miracle,40000000,24719215,0.0,-15280785,B
183,Big Momma's House 2,40000000,138259062,0.0,98259062,B
184,"Big Mommas: Like Father, Like Son",32000000,83615414,0.0,51615414,B
185,Big Trouble,40000000,8493890,1.0,-31506110,B
186,Biker Boyz,24000000,23510601,0.0,-489399,B
187,Billy Lynn's Long Halftime Walk,40000000,30930984,1.0,-9069016,B
188,Birdman,18000000,103215094,0.0,85215094,B
189,Black Mass,53000000,98837872,0.0,45837872,B
190,Black Nativity,17500000,7018189,1.0,-10481811,B
191,Black Snake Moan,15000000,10903846,0.0,-4096154,B
192,Black Swan,13000000,327803731,0.0,314803731,B
193,Black or White,9000000,21571189,0.0,12571189,B
194,Blackhat,70000000,17752940,0.0,-52247060,B
195,Blade II,54000000,155010032,0.0,101010032,B
196,Blade: Trinity,65000000,128905366,0.0,63905366,B
197,Blair Witch,5000000,45172994,0.0,40172994,B
198,Bleed for This,6000000,6174491,0.0,174491,B
199,Blended,40000000,123494610,0.0,83494610,B
200,Blindness,25000000,19844979,1.0,-5155021,B
201,Blood Diamond,100000000,170877916,0.0,70877916,B
202,Blood Work,50000000,26199517,1.0,-23800483,B
203,BloodRayne,25000000,2405420,0.0,-22594580,B
204,Blue Crush,25000000,51842679,0.0,26842679,B
205,Blue Jasmine,18000000,99206215,0.0,81206215,B
206,Boat Trip,20000000,8586376,0.0,-11413624,B
207,Body of Lies,70000000,113280098,1.0,43280098,B
208,Bolt,150000000,309979994,0.0,159979994,B
209,Boogeyman,20000000,67192859,0.0,47192859,B
210,Borat: Cultural Learnings of America for Make Benefit Glorious Nation of Kazakhstan,18000000,261572744,0.0,243572744,B
211,Boyhood,4000000,44349000,0.0,40349000,B
212,Brave,185000000,538983207,0.0,353983207,B
213,Brick Mansions,28000000,68896829,0.0,40896829,B
214,Bride Wars,30000000,114663461,0.0,84663461,B
215,Bridesmaids,32500000,288383523,0.0,255883523,B
216,Bridge of Spies,40000000,165478348,0.0,125478348,B
217,Bridge to Terabithia,60000000,137587063,1.0,77587063,B
218,Bridget Jones's Baby,35000000,211952420,0.0,176952420,B
219,Bridget Jones: The Edge of Reason,50000000,40203020,1.0,-9796980,B
220,Bringing Down the House,20000000,132675402,0.0,112675402,B
221,Brokeback Mountain,14000000,178043761,0.0,164043761,B
222,Broken City,56000000,19701164,0.0,-36298836,B
223,Brooklyn,11000000,62076141,1.0,51076141,B
224,Brooklyn's Finest,17000000,29536299,0.0,12536299,B
225,Brothers,26000000,43318349,0.0,17318349,B
226,Brown Sugar,8000000,27362712,0.0,19362712,B
227,Bruce Almighty,80000000,484572835,0.0,404572835,B
228,Bug,4000000,8059140,0.0,4059140,B
229,Bullet to the Head,55000000,9489829,0.0,-45510171,B
230,Burlesque,55000000,89519773,0.0,34519773,B
231,Burn After Reading,37000000,163720069,0.0,126720069,B
232,Burnt,20000000,36606743,0.0,16606743,B
233,Cabin Fever,1500000,30553394,0.0,29053394,C
234,Calendar Girls,10000000,96542059,0.0,86542059,C
235,Capitalism: A Love Story,20000000,17436509,0.0,-2563491,C
236,Capote,7000000,49084830,0.0,42084830,C
237,Captain America: Civil War,250000000,1153304495,0.0,903304495,C
238,Captain America: The First Avenger,140000000,370569774,0.0,230569774,C
239,Captain America: The Winter Soldier,170000000,714766572,0.0,544766572,C
240,Captain Phillips,55000000,95000000,0.0,40000000,C
241,Captain Underpants: The First Epic Movie,38000000,110824373,1.0,72824373,C
242,Captivity,17000000,2626800,0.0,-14373200,C
243,Carol,11800000,40272135,1.0,28472135,C
244,Cars,120000000,461983149,0.0,341983149,C
245,Cars 2,200000000,559852396,0.0,359852396,C
246,Cars 3,175000000,350170057,0.0,175170057,C
247,Case 39,27000000,29000000,0.0,2000000,C
248,Casino Royale,150000000,599045960,1.0,449045960,C
249,Catch Me If You Can,52000000,352114312,1.0,300114312,C
250,Catch That Kid,18000000,16702864,0.0,-1297136,C
251,Catch and Release,25000000,16158487,0.0,-8841513,C
252,Catwoman,100000000,82102379,0.0,-17897621,C
253,Cellular,25000000,56422687,0.0,31422687,C
254,Central Intelligence,50000000,216972543,0.0,166972543,C
255,Changeling,55000000,113020255,0.0,58020255,C
256,Changing Lanes,45000000,94935764,0.0,49935764,C
257,Chappie,49000000,104399548,0.0,55399548,C
258,Charlie St. Cloud,44000000,48190704,1.0,4190704,C
259,Charlie Wilson's War,75000000,119000410,1.0,44000410,C
260,Charlie and the Chocolate Factory,150000000,474968763,1.0,324968763,C
261,Charlie's Angels: Full Throttle,120000000,259175788,0.0,139175788,C
262,Chasing Liberty,23000000,12,0.0,-22999988,C
263,Cheaper by the Dozen,40000000,190212113,1.0,150212113,C
264,Cheaper by the Dozen 2,60000000,129181830,1.0,69181830,C
265,Chef,11000000,45967935,0.0,34967935,C
266,Chicago,45000000,306776732,0.0,261776732,C
267,Chicken Little,150000000,314432665,0.0,164432665,C
268,Children of Men,76000000,69959751,1.0,-6040249,C
269,Cinderella Man,88000000,108539911,0.0,20539911,C
270,Cirque du Freak: The Vampire's Assistant,40000000,28169671,1.0,-11830329,C
271,City of Ember,55000000,17869048,1.0,-37130952,C
272,Clerks II,5000000,26888376,0.0,21888376,C
273,Click,82500000,237681299,0.0,155181299,C
274,Clockstoppers,26000000,38793283,0.0,12793283,C
275,Clockstoppers,26000000,38793283,0.0,12793283,C
276,Closer,27000000,115505027,0.0,88505027,C
277,Cloud Atlas,102000000,130482868,1.0,28482868,C
278,Cloudy with a Chance of Meatballs,100000000,242988466,0.0,142988466,C
279,Cloudy with a Chance of Meatballs 2,78000000,248384621,0.0,170384621,C
280,Cloverfield,25000000,170764026,0.0,145764026,C
281,Club Dread,8500000,5001655,0.0,-3498345,C
282,Coach Carter,30000000,76669806,0.0,46669806,C
283,Code Name: The Cleaner,20000000,10337477,0.0,-9662523,C
284,Cold Mountain,79000000,173013509,1.0,94013509,C
285,Collateral,65000000,217764291,0.0,152764291,C
286,Collateral Beauty,36000000,87416021,0.0,51416021,C
287,Collateral Damage,85000000,78382433,0.0,-6617567,C
288,College,7000000,6230276,0.0,-769724,C
289,Collide,21500000,4811525,0.0,-16688475,C
290,Colombiana,40000000,60965854,0.0,20965854,C
291,Confessions of a Dangerous Mind,30000000,33013805,0.0,3013805,C
292,Confessions of a Dangerous Mind,30000000,33013805,0.0,3013805,C
293,Confessions of a Shopaholic,40000000,108332743,0.0,68332743,C
294,Confessions of a Teenage Drama Queen,15000000,29331068,1.0,14331068,C
295,Connie and Carla,20000000,11341016,0.0,-8658984,C
296,Constantine,100000000,230884728,0.0,130884728,C
297,Contagion,60000000,137551594,0.0,77551594,C
298,Contraband,25000000,63100000,0.0,38100000,C
299,Conviction,12500000,6732980,0.0,-5767020,C
300,Cop Out,30000000,55583804,0.0,25583804,C
301,Coraline,60000000,124596398,1.0,64596398,C
302,Country Strong,15000000,20529194,0.0,5529194,C
303,Couples Retreat,70000000,171844840,0.0,101844840,C
304,Courageous,1000000,34522221,0.0,33522221,C
305,Cowboys & Aliens,163000000,174822325,0.0,11822325,C
306,Cradle 2 the Grave,25000000,56489558,0.0,31489558,C
307,Crank,12000000,42931041,0.0,30931041,C
308,Crank: High Voltage,20000000,34560577,0.0,14560577,C
309,Crash,6500000,98410061,0.0,91910061,C
310,Crazy Heart,7000000,39462438,1.0,32462438,C
311,"Crazy, Stupid, Love.",50000000,142851197,0.0,92851197,C
312,Creed,37000000,173567581,0.0,136567581,C
313,Crimson Peak,55000000,74679822,0.0,19679822,C
314,Crossover,5800000,7000000,0.0,1200000,C
315,Crossroads,12000000,61141030,0.0,49141030,C
316,Curious George,50000000,69834815,0.0,19834815,C
317,Cursed,35000000,19294901,0.0,-15705099,C
318,Daddy Day Camp,6000000,18197398,0.0,12197398,D
319,Daddy Day Care,60000000,164433867,0.0,104433867,D
320,Daddy's Home,50000000,242786137,0.0,192786137,D
321,Dallas Buyers Club,5000000,55198285,0.0,50198285,D
322,Dan in Real Life,25000000,68377859,0.0,43377859,D
323,Danny Collins,10000000,10835752,0.0,835752,D
324,Daredevil,78000000,179179718,0.0,101179718,D
325,Dark Blue,15000000,9237470,0.0,-5762530,D
326,Dark Shadows,150000000,245527149,0.0,95527149,D
327,Dark Skies,3500000,25174316,0.0,21674316,D
328,Dark Water,30000000,25473093,1.0,-4526907,D
329,Dark Water,30000000,25473093,1.0,-4526907,D
330,Date Movie,20000000,48548426,0.0,28548426,D
331,Date Night,55000000,152263880,0.0,97263880,D
332,Dave Chappelle's Block Party,3000000,11718595,0.0,8718595,D
333,Dawn of the Dead,28000000,102356381,0.0,74356381,D
334,Dawn of the Planet of the Apes,170000000,710644566,0.0,540644566,D
335,Daybreakers,20000000,51416464,0.0,31416464,D
336,Dead Silence,20000000,22217407,0.0,2217407,D
337,Deadpool,58000000,783112979,0.0,725112979,D
338,Dear John,25000000,114977104,1.0,89977104,D
339,Death Race,45000000,73762516,0.0,28762516,D
340,Death Sentence,20000000,16974459,1.0,-3025541,D
341,Deepwater Horizon,110000000,121790373,0.0,11790373,D
342,Defiance,32000000,51155219,0.0,19155219,D
343,Delivery Man,26000000,51164106,0.0,25164106,D
344,Demolition,10000000,1978592,0.0,-8021408,D
345,Denial,10000000,4073489,0.0,-5926511,D
346,Derailed,22000000,57479076,0.0,35479076,D
347,Despicable Me,69000000,543513985,0.0,474513985,D
348,Despicable Me 2,76000000,970761885,0.0,894761885,D
349,Despicable Me 3,80000000,1020063384,0.0,940063384,D
350,Deuce Bigalow: European Gigolo,22000000,22400154,0.0,400154,D
351,Devil,10000000,33583175,0.0,23583175,D
352,Devil's Due,7000000,36433975,0.0,29433975,D
353,Diary of a Wimpy Kid,15000000,75700498,1.0,60700498,D
354,Diary of a Wimpy Kid: Dog Days,22000000,77112176,1.0,55112176,D
355,Diary of a Wimpy Kid: Rodrick Rules,21000000,72417394,1.0,51417394,D
356,Diary of a Wimpy Kid: The Long Haul,22000000,40120144,1.0,18120144,D
357,Did You Hear About the Morgans?,58000000,85280250,0.0,27280250,D
358,Die Another Day,140000000,431971116,0.0,291971116,D
359,Dinner for Schmucks,69000000,86387857,0.0,17387857,D
360,Dirty Dancing: Havana Nights,25000000,27685016,0.0,2685016,D
361,Dirty Grandpa,11500000,94073028,0.0,82573028,D
362,Disaster Movie,25000000,14109284,0.0,-10890716,D
363,District 9,30000000,210819611,0.0,180819611,D
364,Disturbia,20000000,117760134,0.0,97760134,D
365,Divergent,85000000,288747895,1.0,203747895,D
366,Django Unchained,100000000,425368238,0.0,325368238,D
367,Doctor Strange,165000000,677718395,0.0,512718395,D
368,DodgeBall: A True Underdog Story,20000000,167722310,0.0,147722310,D
369,Dolphin Tale,37000000,95404397,0.0,58404397,D
370,Dolphin Tale 2,36000000,52424533,0.0,16424533,D
371,Domino,50000000,22944502,0.0,-27055498,D
372,Don't Be Afraid of the Dark,25000000,36993168,0.0,11993168,D
373,Don't Breathe,9900000,157100845,0.0,147200845,D
374,Doom,60000000,55987321,0.0,-4012679,D
375,Doomsday,30000000,22211426,0.0,-7788574,D
376,Dope,700000,17986781,0.0,17286781,D
377,Doubt,20000000,50907234,0.0,30907234,D
378,Down with Love,35000000,20298207,0.0,-14701793,D
379,Dracula Untold,70000000,215529201,0.0,145529201,D
380,Draft Day,25000000,28831145,0.0,3831145,D
381,Drag Me to Hell,30000000,90810892,0.0,60810892,D
382,Dragonfly,60000000,52322400,0.0,-7677600,D
383,Dream House,50000000,38502340,0.0,-11497660,D
384,Dreamcatcher,68000000,75715436,1.0,7715436,D
385,Dreamgirls,70000000,154937680,0.0,84937680,D
386,Dredd,50000000,41037742,0.0,-8962258,D
387,Drive Angry,50000000,28931401,0.0,-21068599,D
388,Drumline,20000000,57588485,0.0,37588485,D
389,Due Date,65000000,211780824,0.0,146780824,D
390,Dumb and Dumber To,40000000,169837010,0.0,129837010,D
391,Dumb and Dumberer: When Harry Met Lloyd,19000000,39267515,0.0,20267515,D
392,Dunkirk,100000000,519876949,0.0,419876949,D
393,Duplex,40000000,19322135,0.0,-20677865,D
394,Duplicity,78146652,60000000,0.0,-18146652,D
395,Dylan Dog: Dead of Night,20000000,4634062,0.0,-15365938,D
396,Eagle Eye,80000000,178066569,0.0,98066569,E
397,Earth to Echo,13000000,45300000,0.0,32300000,E
398,Eastern Promises,51500000,55112356,0.0,3612356,E
399,Easy A,8000000,74952305,0.0,66952305,E
400,Eat Pray Love,60000000,204594016,1.0,144594016,E
401,Eddie the Eagle,23000000,46152411,0.0,23152411,E
402,Edge of Darkness,80000000,74901339,0.0,-5098661,E
403,Edge of Tomorrow,178000000,370541256,1.0,192541256,E
404,Eight Below,40000000,120455994,0.0,80455994,E
405,Elektra,43000000,56681566,0.0,13681566,E
406,Elf,32000000,173398518,0.0,141398518,E
407,Elizabeth: The Golden Age,55000000,74237563,0.0,19237563,E
408,Elizabethtown,57000000,52034889,0.0,-4965111,E
409,Ella Enchanted,31000000,27388767,1.0,-3611233,E
410,Elysium,115000000,286140700,0.0,171140700,E
411,Empire,4000000,18591272,0.0,14591272,E
412,Employee of the Month,12000000,38368909,0.0,26368909,E
413,Enchanted,85000000,340487652,0.0,255487652,E
414,End of Watch,7000000,48126384,0.0,41126384,E
415,Ender's Game,110000000,125537191,1.0,15537191,E
416,Enough,38000000,51801187,0.0,13801187,E
417,Entourage,30000000,49263404,0.0,19263404,E
418,Epic,100000000,268426634,0.0,168426634,E
419,Epic Movie,20000000,86865564,0.0,66865564,E
420,Eragon,100000000,249288105,1.0,149288105,E
421,Escape Plan,50000000,122915111,0.0,72915111,E
422,Eternal Sunshine of the Spotless Mind,20000000,72258126,0.0,52258126,E
423,Evan Almighty,175000000,173000000,0.0,-2000000,E
424,Ex Machina,15000000,36869414,0.0,21869414,E
425,Exodus: Gods and Kings,140000000,268031828,0.0,128031828,E
426,Exorcist: The Beginning,80000000,78000586,1.0,-1999414,E
427,Expelled: No Intelligence Allowed,3500000,7700000,0.0,4200000,E
428,Extract,8000000,10848783,0.0,2848783,E
429,Extraordinary Measures,31000000,15134293,0.0,-15865707,E
430,Extreme Ops,40000000,10959475,0.0,-29040525,E
431,Extremely Loud & Incredibly Close,40000000,55247881,1.0,15247881,E
432,Eye in the Sky,13000000,18704595,0.0,5704595,E
433,Fahrenheit 9/11,6000000,119114517,0.0,113114517,F
434,Failure to Launch,50000000,128406887,0.0,78406887,F
435,Fantastic Four,120000000,167977596,0.0,47977596,F
436,Fantastic Four,100000000,330579719,0.0,230579719,F
437,Fantastic Mr. Fox,40000000,46471023,1.0,6471023,F
438,Fast & Furious 6,160000000,788679850,0.0,628679850,F
439,Fast Five,125000000,626137675,0.0,501137675,F
440,Faster,24000000,23081726,0.0,-918274,F
441,Femme Fatale,35000000,16838910,0.0,-18161090,F
442,Fences,24000000,64414761,0.0,40414761,F
443,Fever Pitch,30000000,50451307,1.0,20451307,F
444,Fifty Shades Darker,55000000,378827494,1.0,323827494,F
445,Fifty Shades of Black,20000000,21164799,0.0,1164799,F
446,Fifty Shades of Grey,40000000,571006128,1.0,531006128,F
447,Final Destination 2,26000000,90426405,0.0,64426405,F
448,Final Destination 3,25000000,117719158,0.0,92719158,F
449,Final Destination 5,47000000,157887643,0.0,110887643,F
450,Finding Dory,200000000,1028570889,0.0,828570889,F
451,Finding Nemo,94000000,940335536,0.0,846335536,F
452,Finding Neverland,25000000,116766556,0.0,91766556,F
453,Fireproof,500000,33456317,0.0,32956317,F
454,Firewall,45000000,82800000,0.0,37800000,F
455,Flags of Our Fathers,90000000,65900249,0.0,-24099751,F
456,Flicka,15000000,21000000,1.0,6000000,F
457,Flight,31000000,161772375,0.0,130772375,F
458,Flight of the Phoenix,45000000,21009180,1.0,-23990820,F
459,Flightplan,55000000,223387299,0.0,168387299,F
460,Florence Foster Jenkins,29000000,48902953,0.0,19902953,F
461,Flushed Away,149000000,64459316,0.0,-84540684,F
462,Flyboys,60000000,17800000,0.0,-42200000,F
463,Fool's Gold,70000000,111231041,0.0,41231041,F
464,For Your Consideration,12000000,5542025,0.0,-6457975,F
465,Forgetting Sarah Marshall,30000000,105173115,0.0,75173115,F
466,Four Brothers,45000000,92374674,0.0,47374674,F
467,Four Christmases,80000000,163733697,0.0,83733697,F
468,Foxcatcher,24000000,12096300,0.0,-11903700,F
469,Frankenweenie,39000000,35287788,0.0,-3712212,F
470,Freaky Friday,26000000,110230332,1.0,84230332,F
471,Fred Claus,100000000,97838349,0.0,-2161651,F
472,Free Birds,55000000,110000000,0.0,55000000,F
473,Free Fire,10000000,3565109,0.0,-6434891,F
474,Free State of Jones,50000000,25035950,0.0,-24964050,F
475,Freedom Writers,21000000,41170784,0.0,20170784,F
476,Freedomland,37665000,14655628,1.0,-23009372,F
477,Frida,12000000,56298474,0.0,44298474,F
478,Friday After Next,20000000,33526835,0.0,13526835,F
479,Friday Night Lights,30000000,61255921,0.0,31255921,F
480,Friends with Benefits,35000000,150483765,0.0,115483765,F
481,Friends with Money,6500000,13368437,0.0,6868437,F
482,From Justin to Kelly,12000000,4922166,0.0,-7077834,F
483,From Paris with Love,52000000,52826594,0.0,826594,F
484,Frozen,150000000,1274219009,0.0,1124219009,F
485,Fun Size,14000000,11417362,0.0,-2582638,F
486,Fun with Dick and Jane,100000000,202026112,1.0,102026112,F
487,Funny People,75000000,61458982,0.0,-13541018,F
488,Furious 7,190000000,1506249360,0.0,1316249360,F
489,Furry Vengeance,35000000,39340177,0.0,4340177,F
490,G-Force,150000000,292817841,0.0,142817841,G
491,G.I. Joe: Retaliation,130000000,371876278,0.0,241876278,G
492,G.I. Joe: The Rise of Cobra,175000000,302469017,0.0,127469017,G
493,Gamer,50000000,40828540,0.0,-9171460,G
494,Gangs of New York,100000000,193772504,0.0,93772504,G
495,Gangster Squad,60000000,105200903,0.0,45200903,G
496,Garden State,2500000,26781723,0.0,24281723,G
497,Get Hard,40000000,111811453,0.0,71811453,G
498,Get Him to the Greek,40000000,90029656,0.0,50029656,G
499,Get Out,5000000,252434250,0.0,247434250,G
500,Get Rich or Die Tryin',40000000,46442528,0.0,6442528,G
501,Get Smart,80000000,230685453,0.0,150685453,G
502,Ghost Rider,110000000,228738393,0.0,118738393,G
503,Ghost Rider: Spirit of Vengeance,57000000,149217355,0.0,92217355,G
504,Ghost Ship,35000000,68349884,0.0,33349884,G
505,Gifted,7000000,37461045,0.0,30461045,G
506,Gigli,54000000,7266209,0.0,-46733791,G
507,God's Not Dead,17000000,29789000,0.0,12789000,G
508,God's Not Dead 2,5000000,23507567,0.0,18507567,G
509,Gods and Generals,56000000,12923936,1.0,-43076064,G
510,Gods of Egypt,140000000,150680864,0.0,10680864,G
511,Godsend,25000000,30114487,0.0,5114487,G
512,Going the Distance,32000000,42045846,0.0,10045846,G
513,Gold,20000000,7227038,0.0,-12772962,G
514,Gone Baby Gone,19000000,34619699,1.0,15619699,G
515,Gone Girl,61000000,369330363,1.0,308330363,G
516,Good Luck Chuck,25000000,59192128,0.0,34192128,G
517,"Good Night, and Good Luck.",7000000,54600000,0.0,47600000,G
518,Goosebumps,58000000,158162788,1.0,100162788,G
519,Gothika,40000000,141591324,0.0,101591324,G
520,Gracie,9000000,2955039,0.0,-6044961,G
521,Gran Torino,33000000,269958228,0.0,236958228,G
522,Gravity,105000000,716392705,0.0,611392705,G
523,Green Lantern,200000000,219851172,0.0,19851172,G
524,Green Room,5000000,3220371,0.0,-1779629,G
525,Green Zone,100000000,94882889,1.0,-5117111,G
526,Gridiron Gang,30000000,41480851,0.0,11480851,G
527,Grown Ups,80000000,271430189,0.0,191430189,G
528,Grown Ups 2,80000000,246984278,0.0,166984278,G
529,Grudge Match,40000000,44907260,0.0,4907260,G
530,Guardians of the Galaxy,170000000,773328629,0.0,603328629,G
531,Guardians of the Galaxy Vol. 2,200000000,863416141,0.0,663416141,G
532,Guess Who,35000000,68915888,0.0,33915888,G
533,Gulliver's Travels,112000000,237382724,1.0,125382724,G
534,Hacksaw Ridge,40000000,175302354,0.0,135302354,H
535,"Hail, Caesar!",22000000,63647656,0.0,41647656,H
536,Hall Pass,36000000,83160734,0.0,47160734,H
537,Halloween: Resurrection,13000000,37664855,0.0,24664855,H
538,Hancock,150000000,624029371,0.0,474029371,H
539,Hanna,30000000,63782078,0.0,33782078,H
540,Hannibal Rising,50000000,82169884,1.0,32169884,H
541,Happily N'Ever After,47000000,38085778,0.0,-8914222,H
542,Happy Feet,100000000,384335608,0.0,284335608,H
543,Happy Feet Two,130000000,150406466,0.0,20406466,H
544,Hardcore Henry,10000000,14333790,0.0,4333790,H
545,Harry Potter and the Chamber of Secrets,100000000,876688482,1.0,776688482,H
546,Harry Potter and the Goblet of Fire,150000000,895921036,1.0,745921036,H
547,Harry Potter and the Half-Blood Prince,250000000,933959197,1.0,683959197,H
548,Harry Potter and the Order of the Phoenix,150000000,938212738,1.0,788212738,H
549,Harry Potter and the Prisoner of Azkaban,130000000,789804554,1.0,659804554,H
550,Harsh Times,2000000,5967038,0.0,3967038,H
551,Hart's War,70000000,32287044,1.0,-37712956,H
552,Haywire,23000000,33372606,0.0,10372606,H
553,He's Just Not That Into You,40000000,177259441,0.0,137259441,H
554,Heaven is for Real,12000000,101332962,0.0,89332962,H
555,Hell or High Water,12000000,37589296,0.0,25589296,H
556,Hellboy,66000000,99318987,0.0,33318987,H
557,Hellboy II: The Golden Army,85000000,160388063,0.0,75388063,H
558,Hereafter,50000000,105197635,0.0,55197635,H
559,Hidalgo,100000000,108103450,0.0,8103450,H
560,Hidden Figures,25000000,230698791,0.0,205698791,H
561,Hide and Seek,25000000,122644820,0.0,97644820,H
562,High Crimes,42000000,63781810,1.0,21781810,H
563,Hillary's America: The Secret History of the Democratic Party,5000000,13000000,0.0,8000000,H
564,Hitch,70000000,368100420,0.0,298100420,H
565,Hitman,24000000,99965753,0.0,75965753,H
566,Hitman: Agent 47,35000000,81967450,0.0,46967450,H
567,Hollywood Homicide,75000000,51142659,0.0,-23857341,H
568,Home on the Range,110000000,103951461,0.0,-6048539,H
569,Homefront,22000000,43058898,1.0,21058898,H
570,Honey,18000000,62646763,1.0,44646763,H
571,Hop,63000000,183953723,0.0,120953723,H
572,Hope Springs,30000000,114281051,1.0,84281051,H
573,Horrible Bosses,35000000,117000000,0.0,82000000,H
574,Horrible Bosses 2,42000000,107670357,0.0,65670357,H
575,Hostage,52000000,77944725,1.0,25944725,H
576,Hostel,4800000,80578934,0.0,75778934,H
577,Hot Fuzz,12000000,80573774,0.0,68573774,H
578,Hot Pursuit,35000000,51680201,0.0,16680201,H
579,Hot Tub Time Machine,36000000,64572262,0.0,28572262,H
580,Hot Tub Time Machine 2,14000000,12314651,0.0,-1685349,H
581,Hotel Rwanda,17500000,38000000,0.0,20500000,H
582,Hotel Transylvania,85000000,358375603,0.0,273375603,H
583,Hotel Transylvania 2,80000000,473226958,0.0,393226958,H
584,Hotel for Dogs,35000000,73034460,1.0,38034460,H
585,House of Wax,40000000,68766121,0.0,28766121,H
586,House of the Dead,7000000,13818181,0.0,6818181,H
587,How Do You Know,120000000,48668907,0.0,-71331093,H
588,How to Be Single,38000000,112343513,1.0,74343513,H
589,How to Lose a Guy in 10 Days,50000000,177371441,0.0,127371441,H
590,How to Train Your Dragon,165000000,494878759,1.0,329878759,H
591,How to Train Your Dragon 2,145000000,609123048,1.0,464123048,H
592,Hugo,170000000,185770160,1.0,15770160,H
593,Hulk,137000000,245360480,0.0,108360480,H
594,I Am Legend,150000000,585349010,1.0,435349010,I
595,I Am Number Four,50000000,144492830,1.0,94492830,I
596,I Don't Know How She Does It,24000000,30551495,0.0,6551495,I
597,I Know Who Killed Me,12000000,9620399,0.0,-2379601,I
598,"I Love You, Man",41000000,91636986,0.0,50636986,I
599,I Saw the Light,13000000,1646788,0.0,-11353212,I
600,I Spy,70000000,33561137,0.0,-36438863,I
601,I Think I Love My Wife,11000000,13196245,0.0,2196245,I
602,"I, Frankenstein",65000000,71154592,0.0,6154592,I
603,"I, Robot",120000000,347234916,1.0,227234916,I
604,Ice Age,59000000,383257136,0.0,324257136,I
605,Ice Age: Collision Course,105000000,408579038,0.0,303579038,I
606,Ice Age: Continental Drift,95000000,877244782,0.0,782244782,I
607,Ice Age: Dawn of the Dinosaurs,90000000,886686817,0.0,796686817,I
608,Ice Age: The Meltdown,80000000,660940780,0.0,580940780,I
609,Ice Princess,25000000,27645491,0.0,2645491,I
610,Identity,30000000,90259536,0.0,60259536,I
611,Identity Thief,35000000,173965010,0.0,138965010,I
612,If I Stay,11000000,78874843,1.0,67874843,I
613,Igor,25000000,30000000,0.0,5000000,I
614,Immortals,75000000,226904017,0.0,151904017,I
615,In Time,40000000,173930596,0.0,133930596,I
616,In the Cut,12000000,23,1.0,-11999977,I
617,In the Heart of the Sea,100000000,93820758,0.0,-6179242,I
618,In the Land of Women,10000000,17500000,0.0,7500000,I
619,In the Valley of Elah,23000000,29541790,0.0,6541790,I
620,Incarnate,5000000,6341855,0.0,1341855,I
621,Inception,160000000,825532764,0.0,665532764,I
622,Independence Day: Resurgence,165000000,389681935,0.0,224681935,I
623,Indiana Jones and the Kingdom of the Crystal Skull,185000000,786636033,0.0,601636033,I
624,Inferno,75000000,220021259,1.0,145021259,I
625,Inglourious Basterds,70000000,319131050,0.0,249131050,I
626,Inherent Vice,20000000,11110975,1.0,-8889025,I
627,Inkheart,60000000,57490374,1.0,-2509626,I
628,Inside Llewyn Davis,11000000,32935319,0.0,21935319,I
629,Inside Man,45000000,184376254,0.0,139376254,I
630,Inside Out,175000000,857611174,0.0,682611174,I
631,Insidious,1500000,97009150,0.0,95509150,I
632,Insomnia,46000000,113714830,0.0,67714830,I
633,Interstellar,165000000,675120017,0.0,510120017,I
634,Into the Blue,50000000,44434439,0.0,-5565561,I
635,Into the Wild,15000000,56255142,0.0,41255142,I
636,Into the Woods,50000000,212902372,0.0,162902372,I
637,Intolerable Cruelty,60000000,119940815,0.0,59940815,I
638,Invictus,60000000,122233971,0.0,62233971,I
639,Iron Man,140000000,585174222,0.0,445174222,I
640,Iron Man 2,200000000,623933331,0.0,423933331,I
641,Iron Man 3,200000000,1215439994,0.0,1015439994,I
642,Irrational Man,11000000,27391084,0.0,16391084,I
643,It Follows,2000000,14674076,0.0,12674076,I
644,It's Complicated,85000000,219103655,0.0,134103655,I
645,It's Kind of a Funny Story,8000000,6491240,1.0,-1508760,I
646,J. Edgar,35000000,84606030,0.0,49606030,J
647,Jack Reacher,60000000,218340595,1.0,158340595,J
648,Jack Reacher: Never Go Back,60000000,162146076,1.0,102146076,J
649,Jack Ryan: Shadow Recruit,60000000,50549107,0.0,-9450893,J
650,Jack and Jill,79000000,149673788,0.0,70673788,J
651,Jack the Giant Slayer,195000000,197687603,0.0,2687603,J
652,Jackass Presents: Bad Grandpa,15000000,151831537,0.0,136831537,J
653,Jackass: The Movie,5000000,64282312,0.0,59282312,J
654,Jane Got a Gun,25000000,1397284,0.0,-23602716,J
655,Jarhead,72000000,96889998,0.0,24889998,J
656,Jason Bourne,120000000,415484914,0.0,295484914,J
657,Jeepers Creepers 2,17000000,63102666,0.0,46102666,J
658,Jem and the Holograms,5000000,2333684,0.0,-2666316,J
659,Jennifer's Body,16000000,31556061,0.0,15556061,J
660,Jersey Boys,40000000,67347013,0.0,27347013,J
661,Jersey Girl,35000000,36098382,0.0,1098382,J
662,Jobs,12000000,35931410,0.0,23931410,J
663,John Carter,260000000,284139100,1.0,24139100,J
664,John Tucker Must Die,18000000,41009669,0.0,23009669,J
665,John Wick,20000000,88761661,0.0,68761661,J
666,Johnny English,40000000,160583018,0.0,120583018,J
667,Johnny English Reborn,45000000,160078586,0.0,115078586,J
668,Johnson Family Vacation,12000000,31179516,0.0,19179516,J
669,Jonah Hex,47000000,10539000,0.0,-36461000,J
670,Journey 2: The Mysterious Island,79000000,355692760,1.0,276692760,J
671,Journey to the Center of the Earth,45000000,101702060,1.0,56702060,J
672,Joy,60000000,101134059,0.0,41134059,J
673,Julie & Julia,40000000,129540499,0.0,89540499,J
674,Jumper,85000000,222231186,1.0,137231186,J
675,Jumping the Broom,6600000,37710610,0.0,31110610,J
676,Juno,7500000,231411584,0.0,223911584,J
677,Jupiter Ascending,176000003,183987723,0.0,7987720,J
678,Jurassic World,150000000,1513528810,0.0,1363528810,J
679,Just Like Heaven,58000000,102854431,1.0,44854431,J
680,Just Married,18000000,101564935,0.0,83564935,J
681,Just My Luck,28000000,38159905,0.0,10159905,J
682,Justin Bieber: Never Say Never,13000000,98441954,0.0,85441954,J
683,K-19: The Widowmaker,100000000,35168966,0.0,-64831034,K
684,Katy Perry: Part of Me,12000000,32726956,0.0,20726956,K
685,Keanu,15000000,20566327,0.0,5566327,K
686,Keeping Up with the Joneses,40000000,29918745,0.0,-10081255,K
687,Kick-Ass,28000000,96188903,0.0,68188903,K
688,Kick-Ass 2,28000000,60700000,0.0,32700000,K
689,Killer Elite,66000000,57777106,1.0,-8222894,K
690,Killers,75000000,98159963,0.0,23159963,K
691,Killing Them Softly,15000000,37930465,1.0,22930465,K
692,King Arthur,120000000,203567857,0.0,83567857,K
693,King Arthur: Legend of the Sword,175000000,146175066,0.0,-28824934,K
694,King Kong,207000000,550000000,0.0,343000000,K
695,Kingdom of Heaven,130000000,211643158,0.0,81643158,K
696,Kingsman: The Secret Service,81000000,414351546,0.0,333351546,K
697,Knocked Up,30000000,219076518,0.0,189076518,K
698,Knowing,50000000,155446362,0.0,105446362,K
699,Kong: Skull Island,185000000,566652812,0.0,381652812,K
700,Krampus,15000000,61548707,0.0,46548707,K
701,Kubo and the Two Strings,60000000,69929545,0.0,9929545,K
702,Kung Fu Panda,130000000,631744560,0.0,501744560,K
703,Kung Fu Panda 2,150000000,665692281,0.0,515692281,K
704,Kung Fu Panda 3,145000000,521170825,0.0,376170825,K
705,La La Land,30000000,445435700,0.0,415435700,L
706,Labor Day,18000000,20275812,1.0,2275812,L
707,Ladder 49,60000000,74541707,0.0,14541707,L
708,Lady in the Water,75000000,42285169,0.0,-32714831,L
709,Lakeview Terrace,20000000,27640028,0.0,7640028,L
710,Land of the Lost,100000000,68688831,0.0,-31311169,L
711,Lara Croft Tomb Raider: The Cradle of Life,95000000,156505388,0.0,61505388,L
712,Larry Crowne,30000000,36160375,0.0,6160375,L
713,Last Holiday,45000000,38399961,0.0,-6600039,L
714,Last Vegas,28000000,134402450,0.0,106402450,L
715,Law Abiding Citizen,53000000,126690726,0.0,73690726,L
716,Lawless,26000000,53676580,1.0,27676580,L
717,Laws of Attraction,28000000,30016165,0.0,2016165,L
718,Leap Year,19000000,29922472,0.0,10922472,L
719,Leatherheads,58000000,41299492,0.0,-16700508,L
720,Legend of the Guardians: The Owls of Ga'Hoole,80000000,140073390,1.0,60073390,L
721,Legends of Oz: Dorothy's Return,70000000,18662027,1.0,-51337973,L
722,Lemony Snicket's A Series of Unfortunate Events,140000000,209073645,0.0,69073645,L
723,Let Me In,20000000,24145613,1.0,4145613,L
724,Let's Be Cops,17000000,136621271,0.0,119621271,L
725,Let's Go to Prison,4000000,4630045,0.0,630045,L
726,Letters from Iwo Jima,19000000,68673228,0.0,49673228,L
727,License to Wed,35000000,69307224,0.0,34307224,L
728,Life of Pi,120000000,609016565,1.0,489016565,L
729,Lights Out,4900000,148868835,0.0,143968835,L
730,Lilo & Stitch,80000000,145771527,0.0,65771527,L
731,Limitless,27000000,161849455,1.0,134849455,L
732,Lincoln,65000000,275293450,0.0,210293450,L
733,Lion,12000000,140302754,0.0,128302754,L
734,Lions for Lambs,35000000,63215872,0.0,28215872,L
735,Little Black Book,35000000,22034832,0.0,-12965168,L
736,Little Boy,20000000,6485961,0.0,-13514039,L
737,Little Fockers,100000000,310650585,0.0,210650585,L
738,Little Man,64000000,101595121,0.0,37595121,L
739,Little Miss Sunshine,8000000,100523181,0.0,92523181,L
740,Live Free or Die Hard,110000000,383531464,0.0,273531464,L
741,Lockout,20000000,32204030,0.0,12204030,L
742,London Has Fallen,60000000,205754447,0.0,145754447,L
743,Lone Survivor,40000000,149295601,0.0,109295601,L
744,Looney Tunes: Back in Action,80000000,68514844,0.0,-11485156,L
745,Looper,30000000,47042000,0.0,17042000,L
746,Lord of War,42000000,24127895,0.0,-17872105,L
747,Lords of Dogtown,25000000,13411957,0.0,-11588043,L
748,Lost in Translation,4000000,119723856,0.0,115723856,L
749,Love & Friendship,3000000,14016568,0.0,11016568,L
750,Love Actually,40000000,244931766,0.0,204931766,L
751,Love Happens,18000000,36133014,0.0,18133014,L
752,Love in the Time of Cholera,45000000,4607608,1.0,-40392392,L
753,Love the Coopers,17000000,42426912,0.0,25426912,L
754,Lucky Number Slevin,27000000,56308881,0.0,29308881,L
755,Lucy,40000000,126546825,0.0,86546825,L
756,MacGruber,10000000,6110000,0.0,-3890000,M
757,Machete,20000000,31327899,0.0,11327899,M
758,Machete Kills,12000000,15008161,0.0,3008161,M
759,Mad Max: Fury Road,150000000,378858340,0.0,228858340,M
760,Madagascar,75000000,532680671,0.0,457680671,M
761,Madagascar 3: Europe's Most Wanted,145000000,746921274,0.0,601921274,M
762,Madagascar: Escape 2 Africa,150000000,603900354,0.0,453900354,M
763,Made of Honor,40000000,84601681,0.0,44601681,M
764,Magic Mike,7000000,167221571,0.0,160221571,M
765,Magic Mike XXL,14800000,122513057,0.0,107713057,M
766,Magic in the Moonlight,16800000,51029361,0.0,34229361,M
767,Maid in Manhattan,55000000,154906693,0.0,99906693,M
768,Maleficent,180000000,758539785,0.0,578539785,M
769,Mama,15000000,146497771,0.0,131497771,M
770,Mamma Mia!,52000000,609841637,0.0,557841637,M
771,Man of Steel,225000000,662845518,0.0,437845518,M
772,Man of the Year,20000000,41237648,0.0,21237648,M
773,Man on Fire,70000000,130293714,1.0,60293714,M
774,Man on a Ledge,42000000,46221189,0.0,4221189,M
775,Manchester by the Sea,9000000,75026965,0.0,66026965,M
776,Mandela: Long Walk to Freedom,35000000,27330000,0.0,-7670000,M
777,Marci X,20000000,1675706,0.0,-18324294,M
778,Marie Antoinette,40000000,60474340,1.0,20474340,M
779,Marmaduke,50000000,83761844,0.0,33761844,M
780,Mars Needs Moms,150000000,38992758,0.0,-111007242,M
781,Martin Lawrence Live: Runteldat,3000000,19184015,0.0,16184015,M
782,Master and Commander: The Far Side of the World,150000000,212011111,1.0,62011111,M
783,Matchstick Men,62000000,65565672,1.0,3565672,M
784,Max Payne,35000000,85416905,0.0,50416905,M
785,Max Steel,10000000,6272403,0.0,-3727597,M
786,Maze Runner: The Scorch Trials,61000000,311256926,1.0,250256926,M
787,Me Before You,20000000,207945075,1.0,187945075,M
788,Mean Girls,17000000,129042871,0.0,112042871,M
789,Mechanic: Resurrection,40000000,125729635,0.0,85729635,M
790,Meet Dave,60000000,50650079,0.0,-9349921,M
791,Meet the Fockers,80000000,516642939,0.0,436642939,M
792,Meet the Robinsons,150000000,169332978,1.0,19332978,M
793,Meet the Spartans,30000000,84646831,0.0,54646831,M
794,Megamind,130000000,321887208,0.0,191887208,M
795,Memoirs of a Geisha,85000000,162242962,1.0,77242962,M
796,Men in Black II,140000000,441818803,0.0,301818803,M
797,Miami Vice,135000000,163794509,0.0,28794509,M
798,Michael Clayton,25000000,92991835,0.0,67991835,M
799,Middle School: The Worst Years of My Life,8500000,19985196,0.0,11485196,M
800,Midnight in Paris,30000000,151119219,0.0,121119219,M
801,Mike and Dave Need Wedding Dates,33000000,77068246,0.0,44068246,M
802,Milk,20000000,54586584,0.0,34586584,M
803,Million Dollar Arm,25000000,38307627,0.0,13307627,M
804,Million Dollar Baby,30000000,216763646,0.0,186763646,M
805,Mindhunters,27000000,21148829,0.0,-5851171,M
806,Minions,74000000,1156730962,0.0,1082730962,M
807,Minority Report,102000000,358372926,0.0,256372926,M
808,Miracle,28000000,64445708,0.0,36445708,M
809,Miracle at St. Anna,45000000,9323833,1.0,-35676167,M
810,Miracles from Heaven,16000000,73883359,0.0,57883359,M
811,Mirror Mirror,85000000,183018522,0.0,98018522,M
812,Mirrors,35000000,72436439,0.0,37436439,M
813,Miss Peregrine's Home for Peculiar Children,110000000,296485719,1.0,186485719,M
814,Miss Sloane,13000000,3500605,0.0,-9499395,M
815,Mission: Impossible - Ghost Protocol,145000000,694713380,0.0,549713380,M
816,Mission: Impossible - Rogue Nation,150000000,682330139,0.0,532330139,M
817,Mission: Impossible III,150000000,397850012,0.0,247850012,M
818,Moana,150000000,643034466,0.0,493034466,M
819,Moms' Night Out,5000000,10429707,0.0,5429707,M
820,Money Monster,27000000,93282604,0.0,66282604,M
821,Moneyball,50000000,110206216,0.0,60206216,M
822,Monster,8000000,60378584,1.0,52378584,M
823,Monster House,75000000,140175006,0.0,65175006,M
824,Monster Trucks,125000000,64493915,0.0,-60506085,M
825,Monster-in-Law,43000000,154749918,0.0,111749918,M
826,Monsters University,200000000,743559607,0.0,543559607,M
827,Monte Carlo,20000000,17425000,1.0,-2575000,M
828,Moonrise Kingdom,16000000,68263166,0.0,52263166,M
829,Morgan,8000000,8810591,0.0,810591,M
830,Morning Glory,40000000,58785180,0.0,18785180,M
831,Mortdecai,60000000,30418560,1.0,-29581440,M
832,Mother's Day,25000000,48418160,0.0,23418160,M
833,Movie 43,6000000,32438988,0.0,26438988,M
834,Mr. & Mrs. Smith,110000000,478207520,0.0,368207520,M
835,Mr. 3000,30000000,21800302,0.0,-8199698,M
836,Mr. Bean's Holiday,25000000,229736344,0.0,204736344,M
837,Mr. Brooks,20000000,41637263,0.0,21637263,M
838,Mr. Deeds,50000000,171269535,0.0,121269535,M
839,Mr. Peabody & Sherman,145000000,272912430,0.0,127912430,M
840,Mr. Popper's Penguins,55000000,187361754,1.0,132361754,M
841,Mud,10000000,21587700,0.0,11587700,M
842,Munich,70000000,130358911,0.0,60358911,M
843,Muppets Most Wanted,50000000,80383290,0.0,30383290,M
844,Murder by Numbers,50000000,56714147,0.0,6714147,M
845,Music and Lyrics,40000000,145896422,0.0,105896422,M
846,Must Love Dogs,30000000,58405313,1.0,28405313,M
847,My Best Friend's Girl,20000000,36620508,0.0,16620508,M
848,My Big Fat Greek Wedding,5000000,368744044,0.0,363744044,M
849,My Big Fat Greek Wedding 2,18000000,88923251,0.0,70923251,M
850,My Life in Ruins,17000000,20455276,0.0,3455276,M
851,My Sister's Keeper,30000000,95714875,1.0,65714875,M
852,My Soul to Take,25000000,19829957,0.0,-5170043,M
853,My Week with Marilyn,6400000,35057696,0.0,28657696,M
854,Mystic River,25000000,156822020,1.0,131822020,M
855,Nacho Libre,32000000,80197993,0.0,48197993,N
856,Nanny McPhee,25000000,122489822,1.0,97489822,N
857,Napoleon Dynamite,400000,46118097,0.0,45718097,N
858,Narc,6500000,12633747,0.0,6133747,N
859,National Treasure,100000000,347451894,0.0,247451894,N
860,National Treasure: Book of Secrets,130000000,457363168,0.0,327363168,N
861,Nebraska,12000000,17654912,0.0,5654912,N
862,Need for Speed,66000000,203277636,0.0,137277636,N
863,Neighbors,18000000,268157400,0.0,250157400,N
864,Neighbors 2: Sorority Rising,35000000,108758521,0.0,73758521,N
865,Nerve,19000000,85241496,1.0,66241496,N
866,Never Back Down,20000000,41627431,0.0,21627431,N
867,Never Die Alone,3000000,5923000,1.0,2923000,N
868,New Year's Eve,56000000,142044638,0.0,86044638,N
869,New in Town,8000000,29010817,0.0,21010817,N
870,Next,70000000,76066841,1.0,6066841,N
871,Nick and Norah's Infinite Playlist,9000000,32973937,1.0,23973937,N
872,Night at the Museum,110000000,574480841,0.0,464480841,N
873,Night at the Museum: Battle of the Smithsonian,150000000,413106170,0.0,263106170,N
874,Night at the Museum: Secret of the Tomb,127000000,349424282,0.0,222424282,N
875,Nightcrawler,8500000,38697217,0.0,30197217,N
876,Nim's Island,37000000,100076342,1.0,63076342,N
877,Nine,80000000,53825515,0.0,-26174485,N
878,Ninja Assassin,40000000,60462347,0.0,20462347,N
879,No Country for Old Men,25000000,171600000,1.0,146600000,N
880,No Escape,5000000,54418872,0.0,49418872,N
881,No Reservations,28000000,92601050,0.0,64601050,N
882,No Strings Attached,25000000,147780440,0.0,122780440,N
883,Noah,125000000,362637473,0.0,237637473,N
884,Nobel Son,4000000,333912,0.0,-3666088,N
885,Nocturnal Animals,22500000,29252978,1.0,6752978,N
886,Non-Stop,50000000,222809600,0.0,172809600,N
887,Norbit,60000000,95673607,0.0,35673607,N
888,Norm of the North,18000000,17062499,0.0,-937501,N
889,North Country,35000000,25224242,0.0,-9775758,N
890,Notes on a Scandal,15000000,49469904,1.0,34469904,N
891,Now You See Me,75000000,117698894,0.0,42698894,N
892,Now You See Me 2,90000000,334901337,0.0,244901337,N
893,Oblivion,120000000,286168572,0.0,166168572,O
894,Obsessed,20000000,73830340,0.0,53830340,O
895,Ocean's Thirteen,85000000,311312624,0.0,226312624,O
896,Ocean's Twelve,110000000,362744280,0.0,252744280,O
897,Oculus,5000000,44030246,0.0,39030246,O
898,Office Christmas Party,45000000,114501299,0.0,69501299,O
899,Old Dogs,35000000,92219310,0.0,57219310,O
900,Old School,24000000,87055349,0.0,63055349,O
901,Oliver Twist,50000000,42093706,1.0,-7906294,O
902,Olympus Has Fallen,70000000,161025640,0.0,91025640,O
903,Once Upon a Time in Mexico,29000000,98185582,0.0,69185582,O
904,One Day,15000000,59389433,1.0,44389433,O
905,One Hour Photo,12000000,52223306,0.0,40223306,O
906,One Night with the King,20000000,13391174,1.0,-6608826,O
907,Open Range,22000000,68296293,1.0,46296293,O
908,Open Season,85000000,197309027,0.0,112309027,O
909,Open Water,130000,54667954,0.0,54537954,O
910,Orphan,20000000,41596251,0.0,21596251,O
911,Ouija,5000000,103590271,0.0,98590271,O
912,Ouija: Origin of Evil,9000000,81705746,0.0,72705746,O
913,Our Family Wedding,14000000,21409028,0.0,7409028,O
914,Our Idiot Brother,10000000,17273593,0.0,7273593,O
915,Out of Time,50000000,55495563,0.0,5495563,O
916,Out of the Furnace,22000000,15400000,0.0,-6600000,O
917,Over the Hedge,80000000,343397247,0.0,263397247,O
918,P.S. I Love You,30000000,156835339,1.0,126835339,P
919,P2,8000000,7766240,0.0,-233760,P
920,Pacific Rim,180000000,407602906,0.0,227602906,P
921,Paddington,55000000,259207227,1.0,204207227,P
922,Pan,150000000,128388320,1.0,-21611680,P
923,Pandorum,33000000,20645327,0.0,-12354673,P
924,Panic Room,48000000,196397415,0.0,148397415,P
925,Paparazzi,20000000,16605763,0.0,-3394237,P
926,Paper Towns,12000000,85512300,1.0,73512300,P
927,ParaNorman,60000000,107139399,0.0,47139399,P
928,Paranoia,35000000,13785015,1.0,-21214985,P
929,Paranormal Activity,15000,193355800,0.0,193340800,P
930,Paranormal Activity 2,3000000,177512032,0.0,174512032,P
931,Paranormal Activity 3,5000000,205703818,0.0,200703818,P
932,Paranormal Activity 4,5000000,142817992,0.0,137817992,P
933,Paranormal Activity: The Ghost Dimension,10000000,78096553,0.0,68096553,P
934,Paranormal Activity: The Marked Ones,5000000,86362372,0.0,81362372,P
935,Parental Guidance,25000000,119772232,0.0,94772232,P
936,Parker,35000000,46216641,1.0,11216641,P
937,Patriots Day,45000000,50548152,0.0,5548152,P
938,Paul,40000000,97552050,0.0,57552050,P
939,Paul Blart: Mall Cop,26000000,183293131,0.0,157293131,P
940,Paul Blart: Mall Cop 2,38000000,107597242,0.0,69597242,P
941,Pawn Sacrifice,19000000,5578519,0.0,-13421481,P
942,Paycheck,60000000,96269812,0.0,36269812,P
943,Penguins of Madagascar,132000000,373552094,0.0,241552094,P
944,People Like Us,16000000,12434778,0.0,-3565222,P
945,Percy Jackson: Sea of Monsters,90000000,174578751,1.0,84578751,P
946,Perfect Stranger,60795000,73090611,0.0,12295611,P
947,Peter Pan,100000000,121975011,1.0,21975011,P
948,Philomena,12000000,100129872,0.0,88129872,P
949,Phoenix Forgotten,2800000,3600000,0.0,800000,P
950,Phone Booth,13000000,97837138,0.0,84837138,P
951,Pineapple Express,27000000,101624843,0.0,74624843,P
952,Pinocchio,40000000,41323171,1.0,1323171,P
953,Pinocchio,40000000,41323171,1.0,1323171,P
954,Pinocchio,40000000,41323171,1.0,1323171,P
955,Piranha 3D,24000000,83188165,0.0,59188165,P
956,Pirates of the Caribbean: At World's End,300000000,961000000,0.0,661000000,P
957,Pirates of the Caribbean: Dead Man's Chest,200000000,1065659812,0.0,865659812,P
958,Pirates of the Caribbean: Dead Men Tell No Tales,230000000,794191988,0.0,564191988,P
959,Pirates of the Caribbean: On Stranger Tides,380000000,1045713802,1.0,665713802,P
960,Pirates of the Caribbean: The Curse of the Black Pearl,140000000,655011224,0.0,515011224,P
961,Pitch Perfect,17000000,115350426,0.0,98350426,P
962,Pitch Perfect 2,29000000,287506194,0.0,258506194,P
963,Pixels,88000000,243637091,0.0,155637091,P
964,Planes,50000000,219788712,0.0,169788712,P
965,Planes: Fire & Rescue,50000000,151165787,0.0,101165787,P
966,Planet 51,70000000,104945765,0.0,34945765,P
967,Pompeii,130000000,117831631,0.0,-12168369,P
968,Poseidon,160000000,181674817,1.0,21674817,P
969,Post Grad,15000000,6405245,0.0,-8594755,P
970,Predators,40000000,126248813,0.0,86248813,P
971,Premium Rush,35000000,31083599,0.0,-3916401,P
972,Premonition,20000000,84146832,0.0,64146832,P
973,Pride and Prejudice and Zombies,28000000,16374328,1.0,-11625672,P
974,Priest,60000000,78309131,1.0,18309131,P
975,Prince of Persia: The Sands of Time,150000000,335154643,0.0,185154643,P
976,Prisoners,46000000,122126687,0.0,76126687,P
977,Project Almanac,12000000,32248241,0.0,20248241,P
978,Project X,12000000,100000000,0.0,88000000,P
979,Prom,8000000,10130000,0.0,2130000,P
980,Prometheus,130000000,403170142,0.0,273170142,P
981,Public Enemies,80000000,214104620,0.0,134104620,P
982,Pulse,38000000,29907685,0.0,-8092315,P
983,Punch-Drunk Love,25000000,17000000,0.0,-8000000,P
984,Punisher: War Zone,20500000,10089373,0.0,-10410627,P
985,Push,38000000,45465299,0.0,7465299,P
986,Quantum of Solace,200000000,586090727,0.0,386090727,Q
987,Quarantine,12000000,40855419,0.0,28855419,Q
988,Quartet,11000000,59520298,0.0,48520298,Q
989,Queen of Katwe,15000000,10367161,0.0,-4632839,Q
990,Queen of the Damned,35000000,45479110,1.0,10479110,Q
991,R.I.P.D.,130000000,61648500,0.0,-68351500,R
992,RV,50000000,87528173,0.0,37528173,R
993,Race to Witch Mountain,50000000,106303988,1.0,56303988,R
994,Racing Stripes,30000000,93772522,0.0,63772522,R
995,Radio,32000000,52277485,0.0,20277485,R
996,Raise Your Voice,15000000,14867514,0.0,-132486,R
997,Raising Helen,50000000,49718611,0.0,-281389,R
998,Rambo,50000000,113244290,0.0,63244290,R
999,Rango,135000000,245724603,0.0,110724603,R
1000,Ratatouille,150000000,623722818,0.0,473722818,R
1001,Ratchet & Clank,20000000,8821329,0.0,-11178671,R
1002,Ray,40000000,124731534,0.0,84731534,R
1003,Real Steel,110000000,299268508,0.0,189268508,R
1004,Rebound,45000000,16809014,0.0,-28190986,R
1005,Red Dragon,78000000,209196298,1.0,131196298,R
1006,Red Eye,26000000,57891803,0.0,31891803,R
1007,Red Riding Hood,42000000,89162162,0.0,47162162,R
1008,Red Tails,58000000,50365377,0.0,-7634623,R
1009,Reign Over Me,20000000,22222308,0.0,2222308,R
1010,Reign of Fire,60000000,43061982,0.0,-16938018,R
1011,Remember Me,16000000,56032889,0.0,40032889,R
1012,Rendition,27500000,24748670,0.0,-2751330,R
1013,Reno 911!: Miami,10000000,20342161,0.0,10342161,R
1014,Rent,40000000,31670620,0.0,-8329380,R
1015,Repo Men,32000000,18409891,1.0,-13590109,R
1016,Resident Evil,33000000,102984862,0.0,69984862,R
1017,Resident Evil: Afterlife,60000000,300228084,0.0,240228084,R
1018,Resident Evil: Apocalypse,45000000,129394835,0.0,84394835,R
1019,Resident Evil: Extinction,45000000,148412065,0.0,103412065,R
1020,Resident Evil: Retribution,65000000,240159255,0.0,175159255,R
1021,Resident Evil: The Final Chapter,40000000,312242626,0.0,272242626,R
1022,Return to Never Land,20000000,109862682,0.0,89862682,R
1023,Revolutionary Road,35000000,75225693,1.0,40225693,R
1024,Ricki and the Flash,18000000,41325328,0.0,23325328,R
1025,Riddick,38000000,98337295,0.0,60337295,R
1026,Ride Along,25000000,153997819,0.0,128997819,R
1027,Ride Along 2,40000000,124827316,0.0,84827316,R
1028,Righteous Kill,60000000,73174566,0.0,13174566,R
1029,Rings,25000000,83080890,0.0,58080890,R
1030,Rio,90000000,484635760,0.0,394635760,R
1031,Rio 2,103000000,500188435,0.0,397188435,R
1032,Rise of the Guardians,145000000,306941670,0.0,161941670,R
1033,Rise of the Planet of the Apes,93000000,482860185,0.0,389860185,R
1034,Risen,20000000,46069568,0.0,26069568,R
1035,Road to Perdition,80000000,181001478,1.0,101001478,R
1036,Robin Hood,200000000,310669540,0.0,110669540,R
1037,Robots,75000000,260696994,0.0,185696994,R
1038,Rock Dog,60000000,9420546,0.0,-50579454,R
1039,Rock of Ages,75000000,59418613,0.0,-15581387,R
1040,RockNRolla,18000000,25739015,0.0,7739015,R
1041,Rocky Balboa,24000000,155721132,0.0,131721132,R
1042,Rogue One: A Star Wars Story,200000000,1056057273,0.0,856057273,R
1043,Role Models,28000000,92380927,0.0,64380927,R
1044,Room,6000000,35401758,1.0,29401758,R
1045,Rough Night,20000000,45056771,0.0,25056771,R
1046,Rules Don't Apply,25000000,3885342,0.0,-21114658,R
1047,Run All Night,50000000,71561644,0.0,21561644,R
1048,Runaway Jury,60000000,80154140,1.0,20154140,R
1049,Runner Runner,30000000,62616646,0.0,32616646,R
1050,Running Scared,17000000,9500000,0.0,-7500000,R
1051,Rush Hour 3,140000000,258022233,0.0,118022233,R
1052,S.W.A.T.,80000000,116643346,0.0,36643346,S
1053,Safe Haven,28000000,97594140,1.0,69594140,S
1054,Safe House,85000000,208076205,0.0,123076205,S
1055,Sahara,130000000,119269486,1.0,-10730514,S
1056,Salt,110000000,293329073,0.0,183329073,S
1057,San Andreas,110000000,470490832,0.0,360490832,S
1058,Sanctum,30000000,108609310,0.0,78609310,S
1059,Sausage Party,19000000,140705322,0.0,121705322,S
1060,Saving Mr. Banks,35000000,112544580,0.0,77544580,S
1061,Saw,1200000,103911669,0.0,102711669,S
1062,Saw 3D,20000000,136150434,0.0,116150434,S
1063,Saw II,4000000,152925093,0.0,148925093,S
1064,Saw III,10000000,163876815,0.0,153876815,S
1065,Saw IV,10000000,139352633,0.0,129352633,S
1066,Saw V,10800000,113857533,0.0,103057533,S
1067,Saw VI,11000000,68233629,0.0,57233629,S
1068,Scary Movie 3,48000000,220673217,0.0,172673217,S
1069,Scary Movie 4,45000000,178262620,0.0,133262620,S
1070,Scary Movie 5,20000000,78378744,0.0,58378744,S
1071,School for Scoundrels,20000000,17807569,1.0,-2192431,S
1072,School of Rock,35000000,131282949,0.0,96282949,S
1073,Scooby-Doo,84000000,275650703,0.0,191650703,S
1074,Scott Pilgrim vs. the World,60000000,47664559,0.0,-12335441,S
1075,Scouts Guide to the Zombie Apocalypse,15000000,14860766,0.0,-139234,S
1076,Scream 4,40000000,97138686,0.0,57138686,S
1077,Seabiscuit,87000000,148336445,0.0,61336445,S
1078,Season of the Witch,40000000,88100000,0.0,48100000,S
1079,Secret Window,40000000,92913171,1.0,52913171,S
1080,Secretariat,35000000,60251371,0.0,25251371,S
1081,Seed of Chucky,12000000,24829644,0.0,12829644,S
1082,Seeking a Friend for the End of the World,10000000,9636289,0.0,-363711,S
1083,Selma,20000000,66787908,0.0,46787908,S
1084,Serenity,39000000,38869464,0.0,-130536,S
1085,Serving Sara,29000000,16930185,0.0,-12069815,S
1086,Seven Pounds,55000000,168167691,0.0,113167691,S
1087,Seven Psychopaths,15000000,19422261,0.0,4422261,S
1088,Seventh Son,95000000,114178613,1.0,19178613,S
1089,Sex Drive,19000000,18755936,0.0,-244064,S
1090,Sex Tape,40000000,126069509,0.0,86069509,S
1091,Sex and the City,65000000,415252786,0.0,350252786,S
1092,Sex and the City 2,100000000,288347692,0.0,188347692,S
1093,Shanghai Knights,50000000,88323487,0.0,38323487,S
1094,Shark Tale,75000000,367275019,0.0,292275019,S
1095,Shaun of the Dead,4000000,30039392,0.0,26039392,S
1096,She's Out of My League,20000000,49779728,0.0,29779728,S
1097,She's the Man,20000000,33889159,0.0,13889159,S
1098,Sherlock Holmes,90000000,524028679,1.0,434028679,S
1099,Sherlock Holmes: A Game of Shadows,125000000,334615000,1.0,209615000,S
1100,Shoot 'Em Up,39000000,26820641,0.0,-12179359,S
1101,Shooter,61000000,95696996,1.0,34696996,S
1102,Shorts,40000000,28972508,0.0,-11027492,S
1103,Showtime,85000000,77741732,0.0,-7258268,S
1104,Shrek 2,150000000,919838758,0.0,769838758,S
1105,Shrek Forever After,165000000,752600867,0.0,587600867,S
1106,Shrek the Third,160000000,798958165,1.0,638958165,S
1107,Shut In,10000000,13082071,0.0,3082071,S
1108,Shutter Island,80000000,294804195,1.0,214804195,S
1109,Sicario,30000000,84025816,0.0,54025816,S
1110,Sicko,9000000,24538513,0.0,15538513,S
1111,Sideways,16000000,109502303,1.0,93502303,S
1112,Sideways,16000000,109502303,1.0,93502303,S
1113,Signs,72000000,408247917,0.0,336247917,S
1114,Silent Hill,50000000,97607453,0.0,47607453,S
1115,Silent Hill: Revelation 3D,20000000,52302796,0.0,32302796,S
1116,Silent House,2000000,13101672,0.0,11101672,S
1117,Silver Linings Playbook,21000000,205738714,0.0,184738714,S
1118,Sin City,40000000,158733820,0.0,118733820,S
1119,Sinbad: Legend of the Seven Seas,60000000,26288320,0.0,-33711680,S
1120,Sing,75000000,632443719,0.0,557443719,S
1121,Sinister,3000000,77712439,0.0,74712439,S
1122,Sinister 2,10000000,52882018,0.0,42882018,S
1123,Sisters,30000000,105011053,0.0,75011053,S
1124,Sky Captain and the World of Tomorrow,70000000,57958696,0.0,-12041304,S
1125,Sky High,35000000,86369815,0.0,51369815,S
1126,Skyfall,200000000,1108561013,0.0,908561013,S
1127,Skyline,10000000,66821036,0.0,56821036,S
1128,Slackers,14000000,6413915,0.0,-7586085,S
1129,Sleepless,30000000,32540674,0.0,2540674,S
1130,Slow Burn,15500000,1237615,0.0,-14262385,S
1131,Slumdog Millionaire,15000000,377910544,1.0,362910544,S
1132,Smart People,7000000,10569964,0.0,3569964,S
1133,Smokin' Aces,17000000,57103895,0.0,40103895,S
1134,Smurfs: The Lost Village,60000000,197183546,0.0,137183546,S
1135,Snakes on a Plane,33000000,62022014,0.0,29022014,S
1136,Snatched,42000000,60845711,0.0,18845711,S
1137,Snitch,35000000,42930462,0.0,7930462,S
1138,Snow White and the Huntsman,170000000,396600000,0.0,226600000,S
1139,Snowden,40000000,37279439,0.0,-2720561,S
1140,Solaris,47000000,30002758,1.0,-16997242,S
1141,Something Borrowed,35000000,59901913,1.0,24901913,S
1142,Something's Gotta Give,80000000,266728738,0.0,186728738,S
1143,Son of God,22000000,67800064,0.0,45800064,S
1144,Sorority Row,12500000,27206120,0.0,14706120,S
1145,Soul Plane,16000000,14822346,0.0,-1177654,S
1146,Soul Surfer,18000000,47088990,0.0,29088990,S
1147,Source Code,32000000,147332697,0.0,115332697,S
1148,Southpaw,30000000,91709827,0.0,61709827,S
1149,Space Chimps,37000000,63800345,0.0,26800345,S
1150,Spanglish,80000000,55041367,0.0,-24958633,S
1151,Spartan,19250000,8112712,0.0,-11137288,S
1152,Spectre,245000000,880674609,0.0,635674609,S
1153,Speed Racer,120000000,93945766,0.0,-26054234,S
1154,Spider-Man,139000000,821708551,0.0,682708551,S
1155,Spider-Man 2,200000000,783766341,0.0,583766341,S
1156,Spider-Man 3,258000000,890871626,0.0,632871626,S
1157,Spirit: Stallion of the Cimarron,80000000,122563539,0.0,42563539,S
1158,Split,9000000,276921998,0.0,267921998,S
1159,Spotlight,20000000,88346473,0.0,68346473,S
1160,Spring Breakers,5000000,31724284,0.0,26724284,S
1161,Spy,65000000,235666219,0.0,170666219,S
1162,Spy Kids 2: The Island of Lost Dreams,38000000,119723358,0.0,81723358,S
1163,Spy Kids: All the Time in the World,27000000,85564310,0.0,58564310,S
1164,St. Vincent,13000000,54837234,0.0,41837234,S
1165,Star Trek,150000000,385680446,0.0,235680446,S
1166,Star Trek Beyond,185000000,343471816,0.0,158471816,S
1167,Star Trek Into Darkness,190000000,467365246,0.0,277365246,S
1168,Star Trek: Nemesis,60000000,67312826,0.0,7312826,S
1169,Star Wars: Episode II - Attack of the Clones,120000000,649398328,0.0,529398328,S
1170,Star Wars: Episode III - Revenge of the Sith,113000000,850000000,0.0,737000000,S
1171,Star Wars: The Clone Wars,8500000,68282844,0.0,59782844,S
1172,Star Wars: The Force Awakens,245000000,2068223624,0.0,1823223624,S
1173,Stardust,70000000,135560026,1.0,65560026,S
1174,State of Play,60000000,87784194,0.0,27784194,S
1175,Stay,50000000,8342132,0.0,-41657868,S
1176,Stay Alive,9000000,27105095,0.0,18105095,S
1177,Stealth,135000000,76932943,0.0,-58067057,S
1178,Step Brothers,65000000,128107642,0.0,63107642,S
1179,Step Up,12000000,114194847,0.0,102194847,S
1180,Step Up All In,45000000,86165646,0.0,41165646,S
1181,Step Up Revolution,33000000,140470746,0.0,107470746,S
1182,Steve Jobs,30000000,34441873,0.0,4441873,S
1183,Still Alice,5000000,43884652,1.0,38884652,S
1184,Stomp the Yard,13000000,75511123,0.0,62511123,S
1185,Stop-Loss,25000000,11207130,0.0,-13792870,S
1186,Storks,70000000,182379278,0.0,112379278,S
1187,Straight Outta Compton,28000000,201634991,0.0,173634991,S
1188,Stranger Than Fiction,30000000,53653224,0.0,23653224,S
1189,Street Fighter: The Legend of Chun-Li,50000000,12764201,0.0,-37235799,S
1190,Street Kings,20000000,65569869,0.0,45569869,S
1191,Stuart Little 2,120000000,169956806,1.0,49956806,S
1192,Stuck on You,55000000,33828318,0.0,-21171682,S
1193,Sucker Punch,82000000,89792502,0.0,7792502,S
1194,Suicide Squad,175000000,745600054,0.0,570600054,S
1195,Sully,60000000,238470033,0.0,178470033,S
1196,Sunshine Cleaning,5000000,16174377,0.0,11174377,S
1197,Super 8,50000000,260095987,0.0,210095987,S
1198,Superbad,20000000,121463226,0.0,101463226,S
1199,Superhero Movie,35000000,25871834,0.0,-9128166,S
1200,Superman Returns,270000000,391081192,0.0,121081192,S
1201,Surf's Up,85000000,149044513,0.0,64044513,S
1202,Surrogates,80000000,122444772,0.0,42444772,S
1203,Surviving Christmas,45000000,14793624,1.0,-30206376,S
1204,Suspect Zero,27000000,13000000,0.0,-14000000,S
1205,Sweeney Todd: The Demon Barber of Fleet Street,50000000,152000000,0.0,102000000,S
1206,Sweet Home Alabama,30000000,180622424,0.0,150622424,S
1207,Swing Vote,21000000,17600000,0.0,-3400000,S
1208,Swiss Army Man,3000000,4210454,0.0,1210454,S
1209,Sydney White,16500000,13620075,0.0,-2879925,S
1210,Syriana,50000000,94000000,0.0,44000000,S
1211,TMNT,34000000,95608995,0.0,61608995,T
1212,Table 19,5000000,3305592,0.0,-1694408,T
1213,Take Me Home Tonight,19000000,6928068,0.0,-12071932,T
1214,Take the Lead,30000000,34742066,0.0,4742066,T
1215,Taken,25000000,226830568,0.0,201830568,T
1216,Taken 2,45000000,376141306,0.0,331141306,T
1217,Taken 3,48000000,325771424,0.0,277771424,T
1218,Takers,32000000,69055695,0.0,37055695,T
1219,Taking Lives,45000000,65470529,1.0,20470529,T
1220,Talladega Nights: The Ballad of Ricky Bobby,72500000,162966177,0.0,90466177,T
1221,Tammy,20000000,100525432,0.0,80525432,T
1222,Tangled,260000000,591794936,0.0,331794936,T
1223,Taxi,25000000,36609966,0.0,11609966,T
1224,Team America: World Police,32000000,50907422,0.0,18907422,T
1225,Tears of the Sun,70000000,85632458,0.0,15632458,T
1226,Ted,50000000,549368315,0.0,499368315,T
1227,Ted 2,68000000,217022588,0.0,149022588,T
1228,Teenage Mutant Ninja Turtles: Out of the Shadows,135000000,245623848,0.0,110623848,T
1229,Terminator 3: Rise of the Machines,200000000,435000000,0.0,235000000,T
1230,Terminator Salvation,200000000,371353001,0.0,171353001,T
1231,Texas Chainsaw 3D,20000000,47241945,0.0,27241945,T
1232,Thank You for Smoking,6500000,24793509,1.0,18293509,T
1233,That Awkward Moment,8000000,26049082,0.0,18049082,T
1234,That's My Boy,70000000,58058367,0.0,-11941633,T
1235,The 33,25000000,24902723,0.0,-97277,T
1236,The 5th Wave,38000000,109906372,1.0,71906372,T
1237,The A-Team,110000000,177238796,0.0,67238796,T
1238,The Accountant,44000000,155160045,0.0,111160045,T
1239,The Adjustment Bureau,50200000,127869379,0.0,77669379,T
1240,The Adventures of Pluto Nash,100000000,7103973,0.0,-92896027,T
1241,The Adventures of Tintin,130000000,371940071,0.0,241940071,T
1242,The Age of Adaline,25000000,65663276,0.0,40663276,T
1243,The Amazing Spider-Man,215000000,752215857,0.0,537215857,T
1244,The Amazing Spider-Man 2,200000000,705717432,0.0,505717432,T
1245,The American,20000000,65464324,1.0,45464324,T
1246,The Angry Birds Movie,73000000,349779543,0.0,276779543,T
1247,The Ant Bully,50000000,55181129,0.0,5181129,T
1248,The Apparition,17000000,9627492,0.0,-7372508,T
1249,The Artist,15000000,133432856,0.0,118432856,T
1250,The Astronaut Farmer,13000000,11130889,0.0,-1869111,T
1251,The Aviator,116000000,102000000,0.0,-14000000,T
1252,The BFG,140000000,183345589,0.0,43345589,T
1253,The Back-Up Plan,35000000,77477008,0.0,42477008,T
1254,The Bank Job,20000000,64822796,0.0,44822796,T
1255,The Best Exotic Marigold Hotel,10000000,136836156,1.0,126836156,T
1256,The Best Man Holiday,17000000,71625195,0.0,54625195,T
1257,The Best of Me,26000000,35926213,1.0,9926213,T
1258,The Big Bounce,50000000,6808550,1.0,-43191450,T
1259,The Big Short,28000000,133346506,0.0,105346506,T
1260,The Big Wedding,35000000,21819348,0.0,-13180652,T
1261,The Big Year,41000000,7448385,0.0,-33551615,T
1262,The Birth of a Nation,8500000,15861566,0.0,7361566,T
1263,The Black Dahlia,50000000,49111202,1.0,-888798,T
1264,The Blind Side,29000000,309208309,0.0,280208309,T
1265,The Bling Ring,15000000,19145732,0.0,4145732,T
1266,The Book of Eli,80000000,157107755,0.0,77107755,T
1267,The Book of Henry,10000000,4219536,0.0,-5780464,T
1268,The Boss,29000000,78636257,0.0,49636257,T
1269,The Boss Baby,125000000,498814908,0.0,373814908,T
1270,The Bounty Hunter,40000000,136000000,0.0,96000000,T
1271,The Bourne Identity,60000000,214034224,1.0,154034224,T
1272,The Bourne Legacy,130000000,276572938,0.0,146572938,T
1273,The Bourne Supremacy,75000000,288500217,1.0,213500217,T
1274,The Bourne Ultimatum,70000000,442824138,1.0,372824138,T
1275,The Box,30000000,33333531,0.0,3333531,T
1276,The Boxtrolls,60000000,108255770,1.0,48255770,T
1277,The Boy Next Door,4000000,52425855,0.0,48425855,T
1278,The Brave One,70000000,69766619,0.0,-233381,T
1279,The Break-Up,52000000,204999686,0.0,152999686,T
1280,The Bronze,3500000,615816,0.0,-2884184,T
1281,The Brothers Grimm,88000000,105316267,0.0,17316267,T
1282,The Bucket List,45000000,175372502,0.0,130372502,T
1283,The Butterfly Effect,13000000,96060858,0.0,83060858,T
1284,The Bye Bye Man,7400000,26667197,1.0,19267197,T
1285,The Cabin in the Woods,30000000,66486080,0.0,36486080,T
1286,The Call,13000000,68572378,0.0,55572378,T
1287,The Cave,30000000,15007991,0.0,-14992009,T
1288,The Change-Up,52000000,75450437,0.0,23450437,T
1289,The Choice,10000000,18730891,1.0,8730891,T
1290,The Chronicles of Narnia: Prince Caspian,225000000,419651413,1.0,194651413,T
1291,"The Chronicles of Narnia: The Lion, the Witch and the Wardrobe",180000000,748806957,1.0,568806957,T
1292,The Chronicles of Narnia: The Voyage of the Dawn Treader,155000000,415686217,1.0,260686217,T
1293,The Chronicles of Riddick,105000000,115772733,0.0,10772733,T
1294,The Cold Light of Day,20000000,16863583,0.0,-3136417,T
1295,The Collector,3400000,114000000,1.0,110600000,T
1296,The Conjuring,13000000,318000141,0.0,305000141,T
1297,The Conjuring 2,40000000,320170008,0.0,280170008,T
1298,The Conspirator,25000000,15478800,0.0,-9521200,T
1299,The Constant Gardener,25000000,82466670,1.0,57466670,T
1300,The Cookout,16000000,12,0.0,-15999988,T
1301,The Core,60000000,74208267,0.0,14208267,T
1302,The Counselor,25000000,71009334,0.0,46009334,T
1303,The Count of Monte Cristo,35000000,75395048,1.0,40395048,T
1304,The Covenant,20000000,37597471,0.0,17597471,T
1305,The Crazies,20000000,54956140,0.0,34956140,T
1306,The Croods,135000000,585178928,0.0,450178928,T
1307,The Curious Case of Benjamin Button,150000000,333932083,0.0,183932083,T
1308,The D Train,447524,771317,0.0,323793,T
1309,The DUFF,8500000,43528634,0.0,35028634,T
1310,The Da Vinci Code,125000000,767820459,1.0,642820459,T
1311,The Danish Girl,15000000,64191523,1.0,49191523,T
1312,The Darjeeling Limited,16000000,24377151,0.0,8377151,T
1313,The Dark Knight,185000000,1004558444,0.0,819558444,T
1314,The Dark Knight Rises,250000000,1084939099,0.0,834939099,T
1315,The Dark Tower,60000000,71000000,1.0,11000000,T
1316,The Darkest Hour,30000000,64626786,0.0,34626786,T
1317,The Darkness,4000000,10898293,0.0,6898293,T
1318,The Day After Tomorrow,125000000,544272402,0.0,419272402,T
1319,The Debt,20000000,45636368,0.0,25636368,T
1320,The Departed,90000000,289847354,0.0,199847354,T
1321,The Descendants,20000000,177243185,1.0,157243185,T
1322,The Devil Inside,1000000,101758490,0.0,100758490,T
1323,The Devil Wears Prada,35000000,326551094,1.0,291551094,T
1324,The Diary of a Teenage Girl,2000000,1477002,1.0,-522998,T
1325,The Dictator,65000000,179379533,0.0,114379533,T
1326,The Dilemma,70000000,67112664,0.0,-2887336,T
1327,The Drop,12600000,19054534,0.0,6454534,T
1328,The Dukes of Hazzard,50000000,110803676,0.0,60803676,T
1329,The Eagle,25000000,27122040,1.0,2122040,T
1330,The Edge of Seventeen,9000000,18803648,0.0,9803648,T
1331,The Emoji Movie,50000000,66913939,0.0,16913939,T
1332,The Equalizer,55000000,192330738,0.0,137330738,T
1333,The Exorcism of Emily Rose,19000000,144216468,0.0,125216468,T
1334,The Expendables,80000000,274470394,0.0,194470394,T
1335,The Expendables 2,100000000,312573423,0.0,212573423,T
1336,The Expendables 3,90000000,206172544,0.0,116172544,T
1337,The Express,40000000,9793496,0.0,-30206504,T
1338,The Eye,12000000,56309766,0.0,44309766,T
1339,The Fast and the Furious: Tokyo Drift,85000000,158468292,0.0,73468292,T
1340,The Fate of the Furious,250000000,1238764765,0.0,988764765,T
1341,The Fifth Estate,28000000,8555008,0.0,-19444992,T
1342,The Fighter,25000000,93617009,0.0,68617009,T
1343,The Fighting Temptations,15000000,30238577,0.0,15238577,T
1344,The Final Destination,40000000,186167139,0.0,146167139,T
1345,The Finest Hours,80000000,52099090,0.0,-27900910,T
1346,The Five-Year Engagement,30000000,53909751,0.0,23909751,T
1347,The Forbidden Kingdom,55000000,127906624,1.0,72906624,T
1348,The Forest,10000000,40055439,0.0,30055439,T
1349,The Forgotten,42000000,117575636,0.0,75575636,T
1350,The Founder,25000000,23964782,0.0,-1035218,T
1351,The Fountain,35000000,15304890,0.0,-19695110,T
1352,The Four Feathers,35000000,29882645,1.0,-5117355,T
1353,The Fourth Kind,10000000,42333295,0.0,32333295,T
1354,The Gallows,100000,42664410,0.0,42564410,T
1355,The Gambler,25000000,39171130,0.0,14171130,T
1356,The Game Plan,22000000,147880543,0.0,125880543,T
1357,The Ghost Writer,45000000,60222298,1.0,15222298,T
1358,The Girl Next Door,25000000,30411183,1.0,5411183,T
1359,The Giver,25000000,66980456,1.0,41980456,T
1360,The Golden Compass,180000000,372234864,1.0,192234864,T
1361,The Good Dinosaur,175000000,331926147,0.0,156926147,T
1362,The Good Girl,8000000,16856124,0.0,8856124,T
1363,The Good Shepherd,85000000,59908565,0.0,-25091435,T
1364,The Grand Budapest Hotel,30000000,174600318,0.0,144600318,T
1365,The Great Debaters,15000000,30226144,0.0,15226144,T
1366,The Great Raid,80000000,10166502,0.0,-69833498,T
1367,The Great Wall,150000000,331957105,0.0,181957105,T
1368,The Greatest Game Ever Played,25000000,15431177,0.0,-9568823,T
1369,The Green Hornet,120000000,227817248,0.0,107817248,T
1370,The Green Inferno,5000000,6833445,0.0,1833445,T
1371,The Grey,25000000,77278331,1.0,52278331,T
1372,The Grudge,10000000,183474602,0.0,173474602,T
1373,The Grudge 2,20000000,39143839,0.0,19143839,T
1374,The Guardian,70000000,55011732,0.0,-14988268,T
1375,The Guilt Trip,40000000,41863726,0.0,1863726,T
1376,The Gunman,40000000,13644292,1.0,-26355708,T
1377,The Hangover,35000000,459270619,0.0,424270619,T
1378,The Hangover Part II,80000000,254455986,0.0,174455986,T
1379,The Hangover Part III,103000000,362000072,0.0,259000072,T
1380,The Happening,60000000,163403799,0.0,103403799,T
1381,The Hateful Eight,44000000,155760117,0.0,111760117,T
1382,The Haunted Mansion,90000000,182290266,0.0,92290266,T
1383,The Heartbreak Kid,60000000,127766650,0.0,67766650,T
1384,The Heat,43000000,158674180,0.0,115674180,T
1385,The Help,25000000,124272124,1.0,99272124,T
1386,The Hills Have Eyes,15000000,69623713,0.0,54623713,T
1387,The Hitchhiker's Guide to the Galaxy,50000000,104478416,1.0,54478416,T
1388,The Hoax,25000000,11772461,0.0,-13227539,T
1389,The Hobbit: An Unexpected Journey,250000000,1021103568,1.0,771103568,T
1390,The Hobbit: The Battle of the Five Armies,250000000,956019788,1.0,706019788,T
1391,The Hobbit: The Desolation of Smaug,250000000,958400000,1.0,708400000,T
1392,The Holiday,85000000,194168700,0.0,109168700,T
1393,The Hours,25000000,41597830,1.0,16597830,T
1394,The House Bunny,25000000,70442940,0.0,45442940,T
1395,The Hundred-Foot Journey,22000000,88880821,1.0,66880821,T
1396,The Hunger Games,75000000,691210692,1.0,616210692,T
1397,The Hunger Games: Catching Fire,130000000,847423452,1.0,717423452,T
1398,The Hunger Games: Mockingjay - Part 1,125000000,752100229,1.0,627100229,T
1399,The Hunger Games: Mockingjay - Part 2,160000000,653428261,1.0,493428261,T
1400,The Hunted,55000000,34234008,0.0,-20765992,T
1401,The Huntsman: Winter's War,115000000,164602163,0.0,49602163,T
1402,The Ides of March,12500000,75993061,0.0,63493061,T
1403,The Illusionist,40000000,86915017,0.0,46915017,T
1404,The Imaginarium of Doctor Parnassus,30000000,64352607,0.0,34352607,T
1405,The Imitation Game,14000000,233555708,0.0,219555708,T
1406,The Incredible Burt Wonderstone,30000000,27437881,0.0,-2562119,T
1407,The Incredible Hulk,150000000,163712074,0.0,13712074,T
1408,The Incredibles,92000000,631442092,0.0,539442092,T
1409,The Infiltrator,25000000,15436808,0.0,-9563192,T
1410,The Informant!,22000000,35424826,1.0,13424826,T
1411,The Intern,35000000,194564672,0.0,159564672,T
1412,The International,50000000,60161391,0.0,10161391,T
1413,The Internship,58000000,44000000,0.0,-14000000,T
1414,The Interpreter,80000000,162944923,1.0,82944923,T
1415,The Invasion,80000000,15071514,1.0,-64928486,T
1416,The Invention of Lying,18500000,31912793,0.0,13412793,T
1417,The Invisible,30000000,26810113,1.0,-3189887,T
1418,The Invisible,30000000,26810113,1.0,-3189887,T
1419,The Iron Lady,13000000,114956699,0.0,101956699,T
1420,The Island,126000000,162949164,0.0,36949164,T
1421,The Italian Job,60000000,176070171,0.0,116070171,T
1422,The Jacket,29000000,21126225,0.0,-7873775,T
1423,The Judge,50000000,83719388,0.0,33719388,T
1424,The Jungle Book 2,20000000,135680000,1.0,115680000,T
1425,The Karate Kid,40000000,357852395,0.0,317852395,T
1426,The Kids Are All Right,3500000,34705850,0.0,31205850,T
1427,The King's Speech,15000000,414211549,0.0,399211549,T
1428,The Kingdom,70000000,86658558,0.0,16658558,T
1429,The Kite Runner,20000000,73276047,1.0,53276047,T
1430,The Lake House,40000000,114830111,0.0,74830111,T
1431,The Last Airbender,150000000,318502923,0.0,168502923,T
1432,The Last Exorcism,1800000,67738090,0.0,65938090,T
1433,The Last Exorcism Part II,5000000,15179302,0.0,10179302,T
1434,The Last Legion,67000000,25303038,1.0,-41696962,T
1435,The Last Samurai,140000000,456758981,0.0,316758981,T
1436,The Last Witch Hunter,90000000,146936910,0.0,56936910,T
1437,The Lazarus Effect,3300000,64110728,0.0,60810728,T
1438,The League of Extraordinary Gentlemen,78000000,179265204,1.0,101265204,T
1439,The Legend of Hercules,70000000,61279452,0.0,-8720548,T
1440,The Legend of Tarzan,180000000,356743061,1.0,176743061,T
1441,The Legend of Zorro,75000000,142400065,0.0,67400065,T
1442,The Letters,1,1,0.0,0,T
1443,The Life Aquatic with Steve Zissou,50000000,34808403,0.0,-15191597,T
1444,The Life of David Gale,50000000,38955598,0.0,-11044402,T
1445,The Light Between Oceans,20000000,25956113,1.0,5956113,T
1446,The Lincoln Lawyer,40000000,85412898,1.0,45412898,T
1447,The Lizzie McGuire Movie,17000000,55534455,0.0,38534455,T
1448,The Loft,14000000,10076790,0.0,-3923210,T
1449,The Lone Ranger,255000000,89289910,0.0,-165710090,T
1450,The Longest Ride,34000000,63013281,0.0,29013281,T
1451,The Longest Yard,82000000,190320568,0.0,108320568,T
1452,The Lookout,16000000,5367030,0.0,-10632970,T
1453,The Lord of the Rings: The Return of the King,94000000,1118888979,1.0,1024888979,T
1454,The Lord of the Rings: The Two Towers,79000000,926287400,1.0,847287400,T
1455,The Losers,25000000,23580000,0.0,-1420000,T
1456,The Lost City of Z,30000000,8574339,0.0,-21425661,T
1457,The Love Guru,62000000,41819064,0.0,-20180936,T
1458,The Lovely Bones,65000000,93525586,1.0,28525586,T
1459,The Lucky One,25000000,99357138,1.0,74357138,T
1460,The Man with the Iron Fists,15000000,15608545,0.0,608545,T
1461,The Manchurian Candidate,80000000,96105964,1.0,16105964,T
1462,The Marine,20000000,22165608,0.0,2165608,T
1463,The Martian,108000000,630161890,1.0,522161890,T
1464,The Master,32000000,28258060,0.0,-3741940,T
1465,The Matador,10000000,17297244,0.0,7297244,T
1466,The Matrix Reloaded,150000000,738599701,0.0,588599701,T
1467,The Matrix Revolutions,150000000,424988211,0.0,274988211,T
1468,The Maze Runner,34000000,348319861,1.0,314319861,T
1469,The Mechanic,40000000,51070807,0.0,11070807,T
1470,The Men Who Stare at Goats,24000000,68729358,0.0,44729358,T
1471,The Messengers,16000000,1109660,0.0,-14890340,T
1472,The Mist,18000000,57096190,1.0,39096190,T
1473,The Monuments Men,70000000,154984035,0.0,84984035,T
1474,The Mortal Instruments: City of Bones,60000000,90565421,1.0,30565421,T
1475,The Mothman Prophecies,32000000,55157539,1.0,23157539,T
1476,The Mummy: Tomb of the Dragon Emperor,145000000,401128639,0.0,256128639,T
1477,The Muppets,45000000,165184237,0.0,120184237,T
1478,The Nanny Diaries,20000000,47738099,1.0,27738099,T
1479,The Neon Demon,7000000,1333124,0.0,-5666876,T
1480,The New World,30000000,30536013,0.0,536013,T
1481,The Next Three Days,30000000,51148651,0.0,21148651,T
1482,The Nice Guys,50000000,62788218,0.0,12788218,T
1483,The Night Before,25000000,52395996,0.0,27395996,T
1484,The Notebook,29000000,115603229,1.0,86603229,T
1485,The November Man,15000000,32556119,1.0,17556119,T
1486,The Number 23,30000000,77566815,0.0,47566815,T
1487,The Order,35000000,11560806,0.0,-23439194,T
1488,The Other Guys,100000000,170432927,0.0,70432927,T
1489,The Pacifier,56000000,113006880,0.0,57006880,T
1490,The Passion of the Christ,30000000,611899420,0.0,581899420,T
1491,The Peanuts Movie,99000000,246233113,0.0,147233113,T
1492,The Perfect Guy,12000000,60273173,0.0,48273173,T
1493,The Perks of Being a Wallflower,13000000,33400000,1.0,20400000,T
1494,The Phantom of the Opera,70000000,154648887,1.0,84648887,T
1495,The Pianist,35000000,120072577,0.0,85072577,T
1496,The Place Beyond the Pines,15000000,35485608,0.0,20485608,T
1497,The Polar Express,165000000,305875730,0.0,140875730,T
1498,The Possession,14000000,85446075,0.0,71446075,T
1499,The Powerpuff Girls Movie,10000000,11411644,0.0,1411644,T
1500,The Prestige,40000000,109676311,1.0,69676311,T
1501,The Princess Diaries 2: Royal Engagement,40000000,95149435,1.0,55149435,T
1502,The Princess and the Frog,105000000,267045765,1.0,162045765,T
1503,The Producers,45000000,38058335,0.0,-6941665,T
1504,The Proposal,40000000,317375031,0.0,277375031,T
1505,The Punisher,33000000,54700105,0.0,21700105,T
1506,The Purge,3000000,89328627,0.0,86328627,T
1507,The Purge: Anarchy,9000000,108782847,0.0,99782847,T
1508,The Purge: Election Year,10000000,118587880,0.0,108587880,T
1509,The Pursuit of Happyness,55000000,307077295,0.0,252077295,T
1510,The Pyramid,6500000,13865435,0.0,7365435,T
1511,The Queen,15000000,123384128,0.0,108384128,T
1512,The Quiet Ones,200000,17834867,0.0,17634867,T
1513,The Railway Man,18000000,22309223,0.0,4309223,T
1514,The Raven,26000000,29657751,0.0,3657751,T
1515,The Reader,32000000,113019290,1.0,81019290,T
1516,The Reaping,40000000,62771059,0.0,22771059,T
1517,The Return,15000000,11992014,0.0,-3007986,T
1518,The Revenant,135000000,532950503,1.0,397950503,T
1519,The Ring,48000000,249348933,1.0,201348933,T
1520,The Ring Two,50000000,161451538,1.0,111451538,T
1521,The Rite,37000000,96047633,0.0,59047633,T
1522,The Rocker,15000000,8762890,0.0,-6237110,T
1523,The Rookie,20000000,75597042,0.0,55597042,T
1524,The Roommate,16000000,40492759,0.0,24492759,T
1525,The Rover,12250000,2295423,0.0,-9954577,T
1526,The Rum Diary,45000000,24000000,1.0,-21000000,T
1527,The Rundown,85000000,80916492,0.0,-4083508,T
1528,The Santa Clause 2,65000000,172855065,0.0,107855065,T
1529,The Santa Clause 3: The Escape Clause,12000000,84500122,0.0,72500122,T
1530,The Scorpion King,60000000,165333180,0.0,105333180,T
1531,The Second Best Exotic Marigold Hotel,10000000,85978266,0.0,75978266,T
1532,The Secret Life of Bees,11000000,38105395,1.0,27105395,T
1533,The Secret Life of Pets,75000000,875457937,0.0,800457937,T
1534,The Secret Life of Walter Mitty,90000000,188133322,0.0,98133322,T
1535,The Sentinel,60000000,77920346,1.0,17920346,T
1536,The Shack,20000000,57330873,1.0,37330873,T
1537,The Shaggy Dog,50000000,61112916,0.0,11112916,T
1538,The Shallows,17000000,119100758,0.0,102100758,T
1539,The Simpsons Movie,75000000,527068851,0.0,452068851,T
1540,The Sisterhood of the Traveling Pants,25000000,39053061,1.0,14053061,T
1541,The Sisterhood of the Traveling Pants 2,27000000,44352417,1.0,17352417,T
1542,The Sitter,25000000,34942188,0.0,9942188,T
1543,The Skeleton Key,43000000,91974818,0.0,48974818,T
1544,The Smurfs,110000000,563749323,0.0,453749323,T
1545,The Smurfs 2,105000000,347434178,0.0,242434178,T
1546,The Social Network,40000000,224920315,1.0,184920315,T
1547,The Soloist,60000000,31720158,0.0,-28279842,T
1548,The Sorcerer's Apprentice,150000000,215283742,0.0,65283742,T
1549,The Space Between Us,30000000,14793385,0.0,-15206615,T
1550,The Spectacular Now,2500000,6854611,1.0,4354611,T
1551,The Spiderwick Chronicles,90000000,162839667,1.0,72839667,T
1552,The Spirit,60000000,39031337,0.0,-20968663,T
1553,The SpongeBob Movie: Sponge Out of Water,74000000,311594032,0.0,237594032,T
1554,The SpongeBob SquarePants Movie,30000000,140161792,0.0,110161792,T
1555,The Spy Next Door,28000000,45236543,0.0,17236543,T
1556,The Stepford Wives,90000000,102000000,1.0,12000000,T
1557,The Strangers,9000000,82391145,0.0,73391145,T
1558,The Sum of All Fears,68000000,193000000,1.0,125000000,T
1559,The Sweetest Thing,43000000,68696770,0.0,25696770,T
1560,The Switch,19000000,49830607,0.0,30830607,T
1561,The Taking of Pelham 1 2 3,100000000,150166126,0.0,50166126,T
1562,The Tale of Despereaux,60000000,50877145,1.0,-9122855,T
1563,The Terminal,60000000,219417255,0.0,159417255,T
1564,The Texas Chainsaw Massacre,9500000,107071655,0.0,97571655,T
1565,The Theory of Everything,15000000,123726688,0.0,108726688,T
1566,The Three Stooges,30000000,54819301,0.0,24819301,T
1567,The Time Machine,80000000,123729176,1.0,43729176,T
1568,The Time Traveler's Wife,39000000,101229792,1.0,62229792,T
1569,The Tourist,100000000,278731369,0.0,178731369,T
1570,The Town,37000000,154026136,1.0,117026136,T
1571,The Transporter,21000000,43928932,0.0,22928932,T
1572,The Transporter Refueled,25000000,72629670,0.0,47629670,T
1573,The Twilight Saga: Eclipse,68000000,698491347,1.0,630491347,T
1574,The Twilight Saga: New Moon,50000000,709827462,1.0,659827462,T
1575,The Ugly Truth,38000000,205298907,0.0,167298907,T
1576,The Village,60000000,256697520,0.0,196697520,T
1577,The Virginity Hit,2000000,563706,0.0,-1436294,T
1578,The Visit,5000000,98450062,0.0,93450062,T
1579,The Vow,30000000,196114570,0.0,166114570,T
1580,The Walk,35000000,61181942,0.0,26181942,T
1581,The Warrior's Way,42000000,11087569,0.0,-30912431,T
1582,The Watch,68000000,68267862,0.0,267862,T
1583,The Way Back,30000000,20348249,0.0,-9651751,T
1584,The Weather Man,20000000,12482775,0.0,-7517225,T
1585,The Wedding Date,15000000,47175038,0.0,32175038,T
1586,The Whole Ten Yards,40000000,26155781,0.0,-13844219,T
1587,The Wicker Man,40000000,38755073,0.0,-1244927,T
1588,The Wild,80000000,37384046,0.0,-42615954,T
1589,The Witch,3500000,40423945,0.0,36923945,T
1590,The Wolf of Wall Street,100000000,392000694,0.0,292000694,T
1591,The Wolverine,120000000,415440673,0.0,295440673,T
1592,The Woman in Black,17000000,127730736,1.0,110730736,T
1593,The Woman in Black 2: Angel of Death,1000000,26501323,0.0,25501323,T
1594,The Words,6000000,13231461,0.0,7231461,T
1595,The World's End,20000000,46089287,0.0,26089287,T
1596,The Wrestler,6000000,44703995,0.0,38703995,T
1597,The Young Messiah,18500000,6490401,1.0,-12009599,T
1598,The Zookeeper's Wife,20000000,13162475,0.0,-6837525,T
1599,There Will Be Blood,25000000,77208711,1.0,52208711,T
1600,Things We Lost in the Fire,16000000,2849142,0.0,-13150858,T
1601,Think Like a Man,12000000,96070507,0.0,84070507,T
1602,Think Like a Man Too,24000000,70181428,0.0,46181428,T
1603,This Is 40,35000000,88058786,0.0,53058786,T
1604,This Means War,65000000,156974557,0.0,91974557,T
1605,Thor,150000000,449326618,0.0,299326618,T
1606,Thor: The Dark World,170000000,644571402,0.0,474571402,T
1607,Thunderbirds,57000000,28283637,0.0,-28716363,T
1608,Timeline,80000000,43935763,1.0,-36064237,T
1609,To Rome with Love,17000000,73244881,0.0,56244881,T
1610,Tomorrowland,190000000,209154322,0.0,19154322,T
1611,Tooth Fairy,48000000,112462508,0.0,64462508,T
1612,Torque,40000000,46546197,0.0,6546197,T
1613,Tower Heist,75000000,152930623,0.0,77930623,T
1614,Toy Story 3,200000000,1066969703,0.0,866969703,T
1615,Trainwreck,35000000,140795793,0.0,105795793,T
1616,Traitor,22000000,23530831,0.0,1530831,T
1617,Transamerica,1000000,13350369,0.0,12350369,T
1618,Transcendence,100000000,103039258,0.0,3039258,T
1619,Transformers,150000000,709709780,0.0,559709780,T
1620,Transformers: Age of Extinction,210000000,1091405097,0.0,881405097,T
1621,Transformers: Dark of the Moon,195000000,1123746996,0.0,928746996,T
1622,Transformers: Revenge of the Fallen,150000000,836297228,0.0,686297228,T
1623,Transformers: The Last Knight,260000000,604942143,0.0,344942143,T
1624,Transporter 2,32000000,85167639,0.0,53167639,T
1625,Transporter 3,30000000,108979549,0.0,78979549,T
1626,Trapped,30000000,6916869,1.0,-23083131,T
1627,Treasure Planet,140000000,109578115,1.0,-30421885,T
1628,Triple 9,20000000,12639297,0.0,-7360703,T
1629,Trolls,125000000,346864462,0.0,221864462,T
1630,Tropic Thunder,92000000,188072649,0.0,96072649,T
1631,Troy,175000000,497409852,1.0,322409852,T
1632,True Grit,38000000,252276927,1.0,214276927,T
1633,Truth,9600000,2541554,0.0,-7058446,T
1634,Tuck Everlasting,15000000,19158074,1.0,4158074,T
1635,Tupac: Resurrection,300000,7808524,0.0,7508524,T
1636,Turbo,135000000,282570682,0.0,147570682,T
1637,Tusk,2800000,1826705,0.0,-973295,T
1638,Twilight,37000000,392616625,1.0,355616625,T
1639,Twisted,50000000,25195000,0.0,-24805000,T
1640,Two Weeks Notice,60000000,93354918,0.0,33354918,T
1641,Two for the Money,35000000,30526509,0.0,-4473491,T
1642,U2 3D,15000000,22730842,0.0,7730842,U
1643,Ultraviolet,30000000,31070211,0.0,1070211,U
1644,Unbroken,65000000,163442937,1.0,98442937,U
1645,Under the Tuscan Sun,18000000,58878723,1.0,40878723,U
1646,Undercover Brother,25000000,41604473,0.0,16604473,U
1647,Underworld,22000000,95708457,0.0,73708457,U
1648,Underworld: Blood Wars,35000000,81093313,0.0,46093313,U
1649,Underworld: Evolution,50000000,111340801,0.0,61340801,U
1650,Underworld: Rise of the Lycans,35000000,91353501,0.0,56353501,U
1651,Undiscovered,9000000,1046166,0.0,-7953834,U
1652,Undisputed,20000000,12398628,0.0,-7601372,U
1653,Unfaithful,50000000,119137784,0.0,69137784,U
1654,Unfinished Business,35000000,14431253,0.0,-20568747,U
1655,Unfriended,1000000,62882090,0.0,61882090,U
1656,United 93,15000000,76286096,0.0,61286096,U
1657,Unknown,30000000,130786397,1.0,100786397,U
1658,Unknown,3700000,3338228,1.0,-361772,U
1659,Unleashed,45000000,50871113,0.0,5871113,U
1660,Unstoppable,100000000,167805466,0.0,67805466,U
1661,Untraceable,35000000,32483410,0.0,-2516590,U
1662,Up,175000000,735099082,0.0,560099082,U
1663,Up in the Air,25000000,163670000,1.0,138670000,U
1664,Uptown Girls,20000000,37095657,0.0,17095657,U
1665,V for Vendetta,54000000,132511035,0.0,78511035,V
1666,Vacancy,19000000,35300645,0.0,16300645,V
1667,Vacation,31000000,104384188,0.0,73384188,V
1668,Valentine's Day,52000000,216485654,0.0,164485654,V
1669,Valerian and the City of a Thousand Planets,197471676,90024292,0.0,-107447384,V
1670,Valiant,35000000,19478106,0.0,-15521894,V
1671,Valkyrie,75000000,200276000,0.0,125276000,V
1672,Vampires Suck,20000000,80547866,0.0,60547866,V
1673,Van Helsing,160000000,300257475,1.0,140257475,V
1674,Vanity Fair,23000000,16123851,1.0,-6876149,V
1675,Vantage Point,40000000,151161491,0.0,111161491,V
1676,Vicky Cristina Barcelona,15000000,96408652,0.0,81408652,V
1677,Victor Frankenstein,40000000,34227298,1.0,-5772702,V
1678,Volver,12899867,85582407,0.0,72682540,V
1679,W.,25100000,29506464,0.0,4406464,W
1680,Waiting...,3000000,18637690,0.0,15637690,W
1681,Waitress,2000000,22179430,0.0,20179430,W
1682,Walk Hard: The Dewey Cox Story,35000000,18317151,0.0,-16682849,W
1683,Walk the Line,28000000,186438883,0.0,158438883,W
1684,Walking Tall,56000000,57223890,0.0,1223890,W
1685,Wall Street: Money Never Sleeps,70000000,134748021,0.0,64748021,W
1686,Wanderlust,35000000,24159934,0.0,-10840066,W
1687,Wanted,75000000,258270008,0.0,183270008,W
1688,War Dogs,40000000,86234523,0.0,46234523,W
1689,War Horse,66000000,177584879,1.0,111584879,W
1690,War Room,3000000,67790117,0.0,64790117,W
1691,War for the Planet of the Apes,152000000,369907963,0.0,217907963,W
1692,War of the Worlds,132000000,591739379,1.0,459739379,W
1693,Warcraft,160000000,433677183,1.0,273677183,W
1694,Warm Bodies,35000000,116980662,1.0,81980662,W
1695,Warrior,25000000,23057115,0.0,-1942885,W
1696,Watchmen,130000000,185258983,1.0,55258983,W
1697,Water for Elephants,38000000,114156230,1.0,76156230,W
1698,We Are Marshall,65000000,43545364,0.0,-21454636,W
1699,We Are Your Friends,6000000,11122090,0.0,5122090,W
1700,We Bought a Zoo,50000000,120081841,0.0,70081841,W
1701,We Own the Night,21000000,54926886,0.0,33926886,W
1702,We Were Soldiers,75000000,114660784,1.0,39660784,W
1703,We're the Millers,37000000,269994119,0.0,232994119,W
1704,Wedding Crashers,40000000,285176741,0.0,245176741,W
1705,Welcome Home Roscoe Jenkins,35000000,43650785,0.0,8650785,W
1706,Welcome to Mooseport,30000000,14000000,0.0,-16000000,W
1707,What Happens in Vegas,35000000,170000000,0.0,135000000,W
1708,What to Expect When You're Expecting,40000000,79700000,0.0,39700000,W
1709,What's Your Number?,20000000,30426096,1.0,10426096,W
1710,When a Stranger Calls,15000000,66966987,0.0,51966987,W
1711,When the Bough Breaks,10000000,30658387,0.0,20658387,W
1712,When the Game Stands Tall,15000000,30127963,0.0,15127963,W
1713,Where the Wild Things Are,100000000,100086793,0.0,86793,W
1714,While We're Young,10000000,7587485,0.0,-2412515,W
1715,Whip It,15000000,16633035,1.0,1633035,W
1716,Whiskey Tango Foxtrot,35000000,23083334,0.0,-11916666,W
1717,White Chicks,37000000,113086475,0.0,76086475,W
1718,White House Down,150000000,205366737,0.0,55366737,W
1719,White Noise,10000000,91196419,0.0,81196419,W
1720,Whiteout,40000000,12206028,0.0,-27793972,W
1721,Why Him?,38000000,118034273,0.0,80034273,W
1722,Wicker Park,30000000,13001257,0.0,-16998743,W
1723,Wimbledon,31000000,41512007,0.0,10512007,W
1724,Win a Date with Tad Hamilton!,17000000,16980098,0.0,-19902,W
1725,Wind River,11000000,184770205,0.0,173770205,W
1726,Windtalkers,115000000,77628265,0.0,-37371735,W
1727,Winnie the Pooh,30000000,14460000,0.0,-15540000,W
1728,Winter's Tale,60000000,30800231,1.0,-29199769,W
1729,Wish I Was Here,5500000,5483299,0.0,-16701,W
1730,Without a Paddle,19000000,69631118,0.0,50631118,W
1731,Wolf Creek,1000000,27762648,0.0,26762648,W
1732,Woman in Gold,11000000,61619773,0.0,50619773,W
1733,Wonder Woman,149000000,820580447,0.0,671580447,W
1734,Woodlawn,12000000,14394097,0.0,2394097,W
1735,World Trade Center,63000000,162945894,0.0,99945894,W
1736,World War Z,200000000,531865000,1.0,331865000,W
1737,Wrath of the Titans,150000000,301000000,0.0,151000000,W
1738,Wreck-It Ralph,165000000,471222889,0.0,306222889,W
1739,Wrong Turn,12600000,28650575,0.0,16050575,W
1740,X-Men Origins: Wolverine,150000000,373062864,0.0,223062864,X
1741,X-Men: Apocalypse,178000000,543934787,0.0,365934787,X
1742,X-Men: Days of Future Past,250000000,747862775,0.0,497862775,X
1743,X-Men: First Class,160000000,353624124,0.0,193624124,X
1744,X-Men: The Last Stand,210000000,459359555,0.0,249359555,X
1745,Year One,60000000,62357900,0.0,2357900,Y
1746,Yes Man,70000000,225990978,0.0,155990978,Y
1747,Yogi Bear,80000000,201584141,0.0,121584141,Y
1748,You Again,20000000,32005248,0.0,12005248,Y
1749,You Don't Mess with the Zohan,90000000,201596308,0.0,111596308,Y
1750,"You, Me and Dupree",54000000,130431368,0.0,76431368,Y
1751,Young Adult,12000000,22939027,0.0,10939027,Y
1752,Your Highness,49900000,26121638,0.0,-23778362,Y
1753,Yu-Gi-Oh! The Movie,20000000,29170410,0.0,9170410,Y
1754,Zack and Miri Make a Porno,24000000,42105111,0.0,18105111,Z
1755,Zero Dark Thirty,40000000,132820716,0.0,92820716,Z
1756,Zodiac,65000000,84785914,0.0,19785914,Z
1757,Zombieland,23600000,102391382,0.0,78791382,Z
1758,Zookeeper,80000000,169852759,0.0,89852759,Z
1759,Zoolander 2,50000000,55969000,0.0,5969000,Z
1760,Zoom,35000000,12506188,1.0,-22493812,Z
1761,Zootopia,150000000,1023784195,0.0,873784195,Z
